Address A,Port A,Address B,Port B,Packets,Bytes,Stream ID,Total Packets,Percent Filtered,Packets A → B,Bytes A → B,Packets B → A,Bytes B → A,Rel Start,Duration,Bits/s A → B,Bits/s B → A
"192.168.1.177",56144,"192.229.221.95",80,21,1251,0,0,0,11,603,10,648,0,85.771231,56,60
"192.168.1.177",55971,"35.186.224.17",443,5505,1122163,1,0,0,2152,343809,3353,778354,0.418854,3049.12229,902,2042
"192.168.1.177",56165,"216.58.211.227",80,13,767,2,0,0,7,383,6,384,0.51219,45.073396,67,68
"192.168.1.177",56146,"62.183.170.50",80,39,3636,3,0,0,20,1530,19,2106,0.79399,157.117844,77,107
"40.101.1.15",443,"192.168.1.177",56111,1,54,4,0,0,1,54,0,0,1.209363,0,"",""
"216.58.210.138",443,"192.168.1.177",55945,1894,195976,5,0,0,1112,123975,782,72001,1.604885,3562.715232,278,161
"2001:14ba:a051:8c00:61b5:31a4:d1f8:cc83",56245,"2606:4700:20::ac43:4b27",443,5,430,6,0,0,5,430,0,0,2.572279,15.024285999999998,228,0
"192.168.1.177",49819,"35.186.224.41",443,800,56400,7,0,0,400,28600,400,27800,2.587873,6169.101358,37,36
"192.168.1.177",56214,"157.240.205.60",443,20,2901,8,0,0,12,1277,8,1624,2.8005079999999998,196.172282,52,66
"192.168.1.177",55686,"35.186.224.25",443,196,52436,9,0,0,83,10074,113,42362,2.884905,512.312481,157,661
"192.168.1.177",56186,"108.156.15.108",80,13,767,10,0,0,7,383,6,384,2.930922,45.751830999999996,66,67
"192.168.1.177",56188,"108.156.15.108",80,13,767,11,0,0,7,383,6,384,3.054042,45.628651,67,67
"192.168.1.177",56153,"62.183.170.50",80,37,3515,12,0,0,19,1475,18,2040,3.333733,154.57814000000002,76,105
"162.254.198.44",27019,"192.168.1.177",52935,2341,243603,13,0,0,1173,162565,1168,81038,3.477186,6168.365548,210,105
"2001:14ba:a051:8c00:61b5:31a4:d1f8:cc83",56237,"2600:1901:0:38d7::",80,1,86,14,0,0,1,86,0,0,3.875865,0,"",""
"2001:14ba:a051:8c00:61b5:31a4:d1f8:cc83",56238,"2600:1901:0:38d7::",80,1,86,15,0,0,1,86,0,0,4.123814,0,"",""
"192.168.1.177",55872,"35.186.224.17",443,1492,351293,16,0,0,677,262896,815,88397,7.969457,2191.403152,959,322
"192.168.1.177",56138,"34.107.221.82",80,23,1372,17,0,0,12,658,11,714,8.85554,95.99603499999999,54,59
"192.168.1.177",56137,"34.107.221.82",80,23,1372,18,0,0,12,658,11,714,8.855545,95.99612200000001,54,59
"192.168.1.177",56183,"157.240.205.60",443,14,1014,19,0,0,8,573,6,441,12.166204,111.733586,41,31
"192.168.1.62",50496,"192.168.1.177",7680,8,531,20,0,0,5,357,3,174,13.955185,0.00802299999999967,355976,173501
"192.168.1.177",49717,"20.199.120.151",443,313,46393,21,0,0,208,22296,105,24097,16.563364,6125.640018,29,31
"192.168.1.177",55967,"35.186.224.25",443,6,410,22,0,0,3,163,3,247,18.31465,24.937314,52,79
"192.168.1.177",55968,"35.186.224.25",443,10,684,23,0,0,5,273,5,411,18.500137,119.93981099999999,18,27
"192.168.1.177",56195,"157.240.205.60",443,1122,124075,24,0,0,550,56410,572,67665,19.113042,5405.475445,83,100
"192.168.1.177",56247,"40.114.177.156",443,56,16767,25,0,0,24,2877,32,13890,20.706223,22.515532999999998,1022,4935
"192.168.1.177",55972,"35.186.224.17",443,9,629,26,0,0,4,218,5,411,20.869759,74.865152,23,43
"192.168.1.177",56248,"34.120.52.64",443,840,225957,27,0,0,291,41125,549,184832,21.098966,675.908107,486,2187
"2001:14ba:a051:8c00:61b5:31a4:d1f8:cc83",56249,"2a00:1450:4026:808::2003",80,5,430,28,0,0,5,430,0,0,21.154297,15.043767000000003,228,0
"192.168.1.177",56250,"216.58.211.227",80,44,6061,29,0,0,23,2620,21,3441,21.452097,138.487521,151,198
"192.168.1.177",56148,"34.120.208.123",443,96,16478,30,0,0,44,11003,52,5475,21.912725000000002,376.057977,234,116
"2001:14ba:a051:8c00:61b5:31a4:d1f8:cc83",56251,"2606:4700:20::681a:bf0",443,5,430,31,0,0,5,430,0,0,23.603301,15.043332000000003,228,0
"2001:14ba:a051:8c00:61b5:31a4:d1f8:cc83",56252,"2001:67c:4e8:f004::9",443,2,172,32,0,0,2,172,0,0,23.768415,1.001771999999999,1373,0
"192.168.1.177",56253,"149.154.167.99",443,23,8582,33,0,0,11,1561,12,7021,24.035318,2.386201,5233,23538
"192.168.1.177",56254,"192.124.249.22",80,24,4441,34,0,0,12,1092,12,3349,24.155292,67.916099,128,394
"192.168.1.177",56256,"149.154.167.99",443,25,8690,35,0,0,12,1615,13,7075,24.815003,0.5163620000000009,25021,109613
"192.168.1.177",56257,"149.154.167.99",443,910,1704468,36,0,0,310,38319,600,1666149,24.81642,257.55707,1190,51752
"192.168.1.177",56258,"192.124.249.22",80,28,7702,37,0,0,14,1627,14,6075,24.929213,68.141706,191,713
"192.168.1.177",56259,"192.124.249.22",80,28,7702,38,0,0,14,1627,14,6075,24.929378,68.632787,189,708
"192.168.1.177",56160,"35.186.227.140",443,3775,2371687,39,0,0,1803,2181677,1972,190010,25.076847,701.716696,24872,2166
"192.168.1.177",49861,"35.186.224.41",443,820,61295,40,0,0,410,30955,410,30340,27.846663,6129.260052,40,39
"2001:14ba:a051:8c00:61b5:31a4:d1f8:cc83",56260,"2001:67c:4e8:f004::9",443,1,86,41,0,0,1,86,0,0,27.925429,0,"",""
"2001:14ba:a051:8c00:61b5:31a4:d1f8:cc83",56261,"2001:67c:4e8:f004::9",443,1,86,42,0,0,1,86,0,0,27.930131,0,"",""
"192.168.1.177",56262,"149.154.167.99",443,37,10109,43,0,0,19,2434,18,7675,28.180035,170.826591,113,359
"192.168.1.177",56263,"149.154.167.99",443,39,10283,44,0,0,20,2500,19,7783,28.210979,171.040763,116,364
"2001:14ba:a051:8c00:61b5:31a4:d1f8:cc83",56264,"2001:67c:4e8:f004::9",443,5,430,45,0,0,5,430,0,0,28.396943,15.018355999999997,229,0
"192.168.1.177",56227,"213.141.122.228",443,26,3918,46,0,0,14,1560,12,2358,28.584552,170.389909,73,110
"192.168.1.177",56265,"149.154.167.99",443,22,8533,47,0,0,10,1512,12,7021,28.648271,0.1458289999999991,82946,385163
"192.168.1.177",49796,"34.158.0.131",80,300,28191,48,0,0,183,19970,117,8221,31.394197,6120.661840000001,26,10
"2001:14ba:a051:8c00:61b5:31a4:d1f8:cc83",56267,"2001:67c:4e8:f004::9",443,5,430,49,0,0,5,430,0,0,32.455525,15.018518,229,0
"192.168.1.177",56268,"149.154.167.99",443,13706,3589343,50,0,0,7114,1043271,6592,2546072,32.707383,5351.273881,1559,3806
"2001:14ba:a051:8c00:61b5:31a4:d1f8:cc83",56269,"2001:67c:4e8:f004::9",443,5,430,51,0,0,5,430,0,0,34.012882,15.032907000000002,228,0
"192.168.1.177",56270,"149.154.167.99",443,20,8437,52,0,0,10,1514,10,6923,34.264316,0.1465079999999972,82671,378027
"2001:14ba:a051:8c00:61b5:31a4:d1f8:cc83",56273,"2001:67c:4e8:f004::9",443,5,430,53,0,0,5,430,0,0,38.599542,15.048524999999998,228,0
"192.168.1.177",56274,"149.154.167.99",443,22,8545,54,0,0,11,1568,11,6977,38.850267,0.1518249999999952,82621,367633
"192.168.1.177",56275,"34.120.52.64",443,203,37669,55,0,0,83,12905,120,24764,41.281612,183.65086200000002,562,1078
"2001:14ba:a051:8c00:61b5:31a4:d1f8:cc83",56276,"2a01:4f8:c010:1ef1::1",443,1,86,56,0,0,1,86,0,0,42.095806,0,"",""
"2001:14ba:a051:8c00:61b5:31a4:d1f8:cc83",56277,"2a01:4f8:c010:1ef1::1",443,1,86,57,0,0,1,86,0,0,42.096087,0,"",""
"192.168.1.177",56278,"216.58.211.227",80,7,402,58,0,0,4,228,3,174,42.212816,5.415152000000006,336,257
"192.168.1.177",56279,"162.55.83.113",443,747,220162,59,0,0,350,116675,397,103487,42.346363,653.4611,1428,1266
"192.168.1.177",56280,"162.55.83.113",443,19,6742,60,0,0,9,1441,10,5301,42.34663,0.16092100000000187,71637,263533
"192.168.1.177",55696,"35.186.224.25",443,151,45755,61,0,0,74,35207,77,10548,44.01038,554.9070320000001,507,152
"192.168.1.177",56281,"34.117.138.150",443,57,33870,62,0,0,22,2877,35,30993,44.592972,0.3350249999999946,68699,740076
"192.168.1.177",56143,"34.117.14.220",443,11,735,63,0,0,6,426,5,309,47.17446,53.848273999999996,63,45
"192.168.1.177",56142,"34.160.144.191",443,11,763,64,0,0,6,447,5,316,47.174544,53.84685900000001,66,46
"192.168.1.177",56133,"34.117.237.239",443,11,735,65,0,0,6,426,5,309,47.174582,53.851646,63,45
"192.168.1.177",56139,"34.117.65.55",443,11,735,66,0,0,6,426,5,309,47.17463,52.844086,64,46
"192.168.1.177",56150,"34.149.100.209",443,11,735,67,0,0,6,426,5,309,47.174677,53.846609,63,45
"192.168.1.177",56152,"34.110.207.168",443,11,735,68,0,0,6,426,5,309,47.174741,53.846630000000005,63,45
"192.168.1.177",56154,"34.107.141.31",443,11,735,69,0,0,6,426,5,309,47.174775,53.84974,63,45
"192.168.1.177",56147,"35.244.181.201",443,11,763,70,0,0,6,447,5,316,47.174824,53.86037399999999,66,46
"192.168.1.177",56132,"18.165.122.14",443,9,655,71,0,0,6,447,3,208,47.174858,52.625702000000004,67,31
"2001:14ba:a051:8c00:61b5:31a4:d1f8:cc83",56283,"2a04:4e42:3a::760",443,1,86,72,0,0,1,86,0,0,48.070527,0,"",""
"2001:14ba:a051:8c00:61b5:31a4:d1f8:cc83",56284,"2a04:4e42:3a::760",443,1,86,73,0,0,1,86,0,0,48.070735,0,"",""
"2001:14ba:a051:8c00:61b5:31a4:d1f8:cc83",56285,"2a04:4e42:3a::760",443,1,86,74,0,0,1,86,0,0,48.070883,0,"",""
"2001:14ba:a051:8c00:61b5:31a4:d1f8:cc83",56286,"2a04:4e42:3a::760",443,1,86,75,0,0,1,86,0,0,48.071016,0,"",""
"192.168.1.177",56168,"159.69.148.181",443,10,705,76,0,0,6,426,4,279,48.174951,53.657219000000005,63,41
"2001:14ba:a051:8c00:61b5:31a4:d1f8:cc83",56287,"2a04:4e42:3a::760",443,1,86,77,0,0,1,86,0,0,48.309979,0,"",""
"192.168.1.177",56288,"151.101.246.248",443,44,21974,78,0,0,20,2389,24,19585,48.371698,467.665996,40,335
"192.168.1.177",56289,"151.101.246.248",443,45,22260,79,0,0,21,2443,24,19817,48.371967,467.66579500000006,41,338
"192.168.1.177",56290,"151.101.246.248",443,52,28194,80,0,0,22,2497,30,25697,48.372154,467.665671,42,439
"192.168.1.177",56291,"151.101.246.248",443,54,29066,81,0,0,22,2497,32,26569,48.372433,467.66536299999996,42,454
"192.168.1.177",56292,"151.101.246.248",443,23,2093,82,0,0,11,1180,12,913,48.613517,247.235386,38,29
"192.168.1.177",56293,"149.154.167.99",443,23,9847,83,0,0,12,2693,11,7154,49.421709,0.22236300000000142,96886,257380
"192.168.1.177",56191,"172.64.154.86",443,9,627,84,0,0,6,426,3,201,50.289995,53.523526,63,30
"192.168.1.177",56185,"108.156.22.78",443,9,627,85,0,0,6,426,3,201,50.290238,53.51505999999999,63,30
"192.168.1.177",56184,"108.156.22.78",443,10,681,86,0,0,6,426,4,255,50.290429,52.51287099999999,64,38
"192.168.1.177",56190,"3.214.211.112",443,11,735,87,0,0,6,426,5,309,51.290627,54.041377,63,45
"192.168.1.177",56193,"13.107.213.53",443,5,362,88,0,0,2,154,3,208,51.290717,4.654730999999998,264,357
"192.168.1.177",56172,"104.18.37.228",443,9,627,89,0,0,6,426,3,201,52.291383,53.591846,63,30
"192.168.1.177",56294,"149.154.167.99",443,20,8815,90,0,0,9,1903,11,6912,53.478473,0.10462400000000116,145511,528521
"192.168.1.62",50508,"192.168.1.177",7680,8,531,91,0,0,5,357,3,174,53.972384,0.009741000000005329,293193,142901
"192.168.1.177",56296,"149.154.167.99",443,23,9851,92,0,0,12,2697,11,7154,55.050494,0.18431900000000212,117057,310505
"150.171.22.254",443,"192.168.1.177",56164,1,54,93,0,0,1,54,0,0,55.790238,0,"",""
"13.107.6.254",443,"192.168.1.177",56169,1,54,94,0,0,1,54,0,0,56.907158,0,"",""
"192.168.1.177",56298,"149.154.167.99",443,22,9797,95,0,0,11,2643,11,7154,59.652989,0.15566499999999905,135830,367661
"13.107.213.53",443,"192.168.1.177",56177,1,54,96,0,0,1,54,0,0,59.729593,0,"",""
"192.168.1.177",50062,"195.148.124.36",80,10,1226,97,0,0,6,504,4,722,68.202155,0.01346900000000062,299354,428836
"13.107.246.53",443,"192.168.1.177",56243,10,617,98,0,0,2,185,8,432,68.952265,5225.110266,0,0
"192.168.1.177",50064,"188.166.241.168",80,10,1228,99,0,0,6,505,4,723,74.732385,0.8207270000000051,4922,7047
"52.108.8.254",443,"192.168.1.177",56221,1,54,100,0,0,1,54,0,0,89.806142,0,"",""
"52.97.200.146",443,"192.168.1.177",56216,1,54,101,0,0,1,54,0,0,90.192077,0,"",""
"192.168.1.62",50531,"192.168.1.177",7680,8,531,102,0,0,5,357,3,174,93.984142,0.006040999999996188,472769,230425
"104.123.68.49",443,"192.168.1.177",56217,10,571,103,0,0,2,139,8,432,95.404918,5198.657633,0,0
"20.189.173.9",443,"192.168.1.177",56219,1,54,104,0,0,1,54,0,0,99.292258,0,"",""
"192.168.1.177",56304,"149.154.167.99",443,326,1069336,105,0,0,105,13921,221,1055415,109.940978,50.04906,2225,168700
"2001:14ba:a051:8c00:61b5:31a4:d1f8:cc83",56305,"2001:b28:f23f:9::852:438",443,5,430,106,0,0,5,430,0,0,112.296068,15.037453,228,0
"192.168.1.177",56307,"149.154.167.99",443,36,21389,107,0,0,17,3469,19,17920,112.51474,30.274636,916,4735
"192.168.1.177",56308,"149.154.170.200",443,52,38822,108,0,0,22,3432,30,35390,112.559489,54.292728999999994,505,5214
"62.165.159.17",443,"192.168.1.177",56241,10,571,109,0,0,2,139,8,432,113.41555,5180.646959000001,0,0
"204.79.197.222",443,"192.168.1.177",56179,1,54,110,0,0,1,54,0,0,114.204691,0,"",""
"104.123.68.50",443,"192.168.1.177",56187,10,571,111,0,0,2,139,8,432,116.008884,5178.05363,0,0
"13.107.18.254",443,"192.168.1.177",56224,1,54,112,0,0,1,54,0,0,120.280918,0,"",""
"192.168.1.177",56311,"149.154.170.200",443,22,8058,113,0,0,8,1463,14,6595,133.345604,1.1962289999999882,9784,44105
"192.168.1.62",50541,"192.168.1.177",7680,8,531,114,0,0,5,357,3,174,133.991461,0.011765000000025339,242753,118317
"152.199.19.161",443,"192.168.1.177",56223,11,689,115,0,0,3,257,8,432,148.468774,5145.593757,0,0
"192.168.1.62",50551,"192.168.1.177",7680,8,531,116,0,0,5,357,3,174,173.99612,0.006050000000016098,472066,230082
"2001:14ba:a051:8c00:61b5:31a4:d1f8:cc83",56317,"2a05:d014:58f:6202::64",80,5,430,117,0,0,5,430,0,0,186.475111,15.022126000000014,228,0
"2001:14ba:a051:8c00:61b5:31a4:d1f8:cc83",56320,"2a05:d014:58f:6201::64",80,5,430,118,0,0,5,430,0,0,207.498052,15.035287000000011,228,0
"192.168.1.62",50583,"192.168.1.177",7680,8,531,119,0,0,5,357,3,174,214.015098,0.012098000000008824,236072,115060
"192.168.1.177",56323,"40.114.177.156",443,10,5853,120,0,0,5,1563,5,4290,226.497879,0.09526599999998098,131253,360254
"192.168.1.177",56324,"40.114.177.156",443,10,5853,121,0,0,5,1563,5,4290,226.692297,0.08206500000000005,152367,418205
"192.168.1.177",56325,"3.70.101.28",80,15,1268,122,0,0,8,553,7,715,228.541577,67.91543700000003,65,84
"192.168.1.177",56326,"3.70.101.28",443,24,6428,123,0,0,13,1326,11,5102,228.598318,67.85869600000001,156,601
"192.168.1.177",56327,"34.117.237.239",443,32,4653,124,0,0,17,2758,15,1895,229.16748,171.027197,129,88
"34.117.65.55",443,"192.168.1.177",56149,43,2974,125,0,0,27,1748,16,1226,229.951072,3300.0520690000003,4,2
"192.168.1.177",56329,"62.165.155.56",443,34,10824,126,0,0,17,3332,17,7492,238.703316,30.311439999999976,879,1977
"192.168.1.177",56330,"62.165.155.56",443,32,10102,127,0,0,16,2951,16,7151,238.703832,30.249691000000013,780,1891
"192.168.1.177",56331,"62.165.155.56",443,32,10095,128,0,0,15,2890,17,7205,238.70427,30.249187000000006,764,1905
"192.168.1.177",56333,"34.120.52.64",443,2326,292168,129,0,0,897,129110,1429,163058,249.169732,5185.167055,199,251
"192.168.1.62",50588,"192.168.1.177",7680,8,531,130,0,0,5,357,3,174,254.016822,0.010874999999998636,262620,128000
"192.168.1.62",50598,"192.168.1.177",7680,8,531,131,0,0,5,357,3,174,294.034353,0.0297429999999963,96022,46800
"2001:14ba:a051:8c00:61b5:31a4:d1f8:cc83",56338,"2600:1901:1:c36::",443,1,86,132,0,0,1,86,0,0,295.858097,0,"",""
"2001:14ba:a051:8c00:61b5:31a4:d1f8:cc83",56339,"2600:1901:1:c36::",443,1,86,133,0,0,1,86,0,0,296.104943,0,"",""
"2001:14ba:a051:8c00:61b5:31a4:d1f8:cc83",56340,"2600:1901:1:c36::",443,1,86,134,0,0,1,86,0,0,296.149835,0,"",""
"192.168.1.177",56341,"35.186.224.25",443,379,42750,135,0,0,175,17110,204,25640,296.164638,2926.400883,46,70
"192.168.1.177",56342,"35.186.224.25",443,22,2675,136,0,0,11,1255,11,1420,296.461958,219.579569,45,51
"192.168.1.177",56346,"149.154.167.99",443,40,10812,137,0,0,21,3137,19,7675,328.508341,170.85242900000003,146,359
"192.168.1.62",50611,"192.168.1.177",7680,8,531,138,0,0,5,357,3,174,334.048162,0.015010000000017953,190273,92738
"192.168.1.62",50627,"192.168.1.177",7680,8,531,139,0,0,5,357,3,174,374.064837,0.00590999999997166,483248,235532
"192.168.1.177",56353,"34.110.207.168",443,28,4005,140,0,0,15,2416,13,1589,395.942364,170.68594800000005,113,74
"192.168.1.62",50652,"192.168.1.177",7680,8,531,141,0,0,5,357,3,174,414.075753,0.005216999999959171,547441,266820
"192.168.1.62",50674,"192.168.1.177",7680,8,531,142,0,0,5,357,3,174,454.090231,0.009063999999966654,315092,153574
"192.168.1.62",50688,"192.168.1.177",7680,8,531,143,0,0,5,357,3,174,494.092593,0.005473999999992429,521739,254293
"192.168.1.177",56364,"95.216.67.183",443,14,6002,144,0,0,7,1063,7,4939,502.438225,0.12710900000001857,66903,310851
"2001:14ba:a051:8c00:61b5:31a4:d1f8:cc83",56365,"2a01:4f8:271:134e::2",443,1,86,145,0,0,1,86,0,0,502.444339,0,"",""
"192.168.1.177",56366,"62.183.170.50",80,32,3218,146,0,0,17,1375,15,1843,502.49774,115.92443200000002,94,127
"2001:14ba:a051:8c00:61b5:31a4:d1f8:cc83",56368,"2600:1901:1:c36::",443,1,86,147,0,0,1,86,0,0,516.042296,0,"",""
"2001:14ba:a051:8c00:61b5:31a4:d1f8:cc83",56369,"2600:1901:1:c36::",443,1,86,148,0,0,1,86,0,0,516.288358,0,"",""
"192.168.1.177",56370,"35.186.224.25",443,1299,244145,149,0,0,560,71330,739,172815,516.351185,3658.861649,155,377
"192.168.1.177",56371,"35.186.224.25",443,42,4002,150,0,0,21,1805,21,2197,516.598586,660.027058,21,26
"2001:14ba:a051:8c00:61b5:31a4:d1f8:cc83",56373,"2a03:2880:f213:c3:face:b00c:0:167",443,1,86,151,0,0,1,86,0,0,523.329452,0,"",""
"2001:14ba:a051:8c00:61b5:31a4:d1f8:cc83",56374,"2a03:2880:f213:c3:face:b00c:0:167",443,1,86,152,0,0,1,86,0,0,523.329663,0,"",""
"192.168.1.177",56375,"157.240.205.60",443,41,10025,153,0,0,22,4669,19,5356,523.590624,170.15924799999993,219,251
"192.168.1.177",56376,"157.240.205.60",443,21,5567,154,0,0,10,1491,11,4076,523.590786,0.027679000000034648,430940,1178077
"192.168.1.177",56378,"20.42.65.89",443,36,12131,155,0,0,19,6045,17,6086,532.816965,1.2075069999999641,40049,40321
"192.168.1.62",50694,"192.168.1.177",7680,8,531,156,0,0,5,357,3,174,534.096377,0.008700000000089858,328275,159999
"192.168.1.177",56381,"34.120.208.123",443,37,6624,157,0,0,19,4038,18,2586,560.373291,170.65545699999996,189,121
"192.168.1.62",50724,"192.168.1.177",7680,8,531,158,0,0,5,357,3,174,574.111495,0.007875000000012733,362666,176761
"192.168.1.62",50755,"192.168.1.177",7680,8,531,159,0,0,5,357,3,174,614.125114,0.008984999999938736,317863,154924
"192.168.1.177",56388,"149.154.167.99",443,39,10780,160,0,0,20,3083,19,7697,629.640935,171.017878,144,360
"192.168.1.62",50770,"192.168.1.177",7680,8,531,161,0,0,5,357,3,174,654.128651,0.01985700000000179,143828,70101
"192.168.1.177",50152,"195.148.124.36",80,10,1226,162,0,0,6,504,4,722,668.812848,0.011804999999981192,341550,489284
"192.168.1.177",50076,"188.166.241.168",80,10,1228,163,0,0,6,505,4,723,675.673516,0.8465510000000904,4772,6832
"2001:14ba:a051:8c00:61b5:31a4:d1f8:cc83",56396,"2600:1901:1:c36::",443,1,86,164,0,0,1,86,0,0,688.828146,0,"",""
"2001:14ba:a051:8c00:61b5:31a4:d1f8:cc83",56397,"2600:1901:1:c36::",443,1,86,165,0,0,1,86,0,0,689.085526,0,"",""
"192.168.1.177",56398,"35.186.224.25",443,776,258297,166,0,0,388,220140,388,38157,689.131414,3689.8590580000005,477,82
"192.168.1.177",56399,"35.186.224.25",443,42,4002,167,0,0,21,1805,21,2197,689.395805,660.0607739999999,21,26
"192.168.1.62",50788,"192.168.1.177",7680,8,531,168,0,0,5,357,3,174,694.145026,0.00746399999991354,382636,186495
"192.168.1.177",56405,"35.186.227.140",443,979,274977,169,0,0,397,220719,582,54258,732.220946,1437.4357439999999,1228,301
"192.168.1.62",50799,"192.168.1.177",7680,8,531,170,0,0,5,357,3,174,734.157701,0.005172000000015942,552204,269141
"192.168.1.62",50809,"192.168.1.177",7680,8,531,171,0,0,5,357,3,174,774.161888,0.007522999999991953,379635,185032
"192.168.1.62",50825,"192.168.1.177",7680,8,531,172,0,0,5,357,3,174,814.164232,0.010921000000053027,261514,127460
"192.168.1.177",56416,"34.120.52.64",443,88,14353,173,0,0,39,6149,49,8204,841.813063,396.04013499999996,124,165
"192.168.1.62",50828,"192.168.1.177",7680,8,531,174,0,0,5,357,3,174,854.167269,0.005170000000020991,552417,269245
"192.168.1.177",56418,"95.216.67.183",443,34,8637,175,0,0,15,2288,19,6349,861.501471,45.93261199999995,398,1105
"2001:14ba:a051:8c00:61b5:31a4:d1f8:cc83",56419,"2a01:4f8:271:134e::2",443,1,86,176,0,0,1,86,0,0,861.506805,0,"",""
"192.168.1.62",50843,"192.168.1.177",7680,8,531,177,0,0,5,357,3,174,894.178618,0.006424999999921965,444513,216653
"192.168.1.177",56425,"34.120.208.123",443,61,10904,178,0,0,29,6645,32,4259,912.845558,238.3639250000001,223,142
"192.168.1.177",56428,"149.154.167.99",443,37,10650,179,0,0,18,2975,19,7675,929.6107,170.715602,139,359
"192.168.1.62",50873,"192.168.1.177",7680,8,531,180,0,0,5,357,3,174,934.192461,0.00578100000006998,494032,240788
"192.168.1.62",50885,"192.168.1.177",7680,8,531,181,0,0,5,357,3,174,974.202622,0.013184000000023843,216626,105582
"2001:14ba:a051:8c00:61b5:31a4:d1f8:cc83",56433,"2a05:d014:58f:6202::64",80,5,430,182,0,0,5,430,0,0,977.665368,15.04055900000003,228,0
"192.168.1.177",56434,"40.114.177.156",443,11,5288,183,0,0,5,944,6,4344,979.274675,0.07034599999997226,107355,494015
"192.168.1.177",56435,"40.114.177.156",443,5,330,184,0,0,1,66,4,264,979.477881,7.179894999999988,73,294
"192.168.1.177",56436,"40.114.177.156",443,32,7705,185,0,0,14,2005,18,5700,979.573043,20.235284999999976,792,2253
"192.168.1.177",56437,"140.177.50.10",443,127,176721,186,0,0,39,7171,88,169550,979.796523,4.561732000000006,12575,297343
"192.168.1.177",56438,"192.124.249.22",80,24,4441,187,0,0,12,1092,12,3349,980.117204,64.94732600000009,134,412
"192.168.1.177",56439,"140.177.50.10",443,68,215505,188,0,0,24,3273,44,212232,980.5236,3.6712630000000672,7132,462471
"192.168.1.177",56440,"140.177.50.10",443,64,119605,189,0,0,22,4227,42,115378,980.539623,3.7052999999999656,9126,249109
"192.168.1.177",56441,"140.177.50.10",443,57,121715,190,0,0,20,3408,37,118307,980.542335,3.549323000000072,7681,266658
"192.168.1.177",56442,"140.177.50.10",443,64,95745,191,0,0,24,4138,40,91607,980.551014,3.792771000000016,8728,193224
"192.168.1.177",56443,"140.177.50.10",443,86,123005,192,0,0,29,5111,57,117894,980.555597,3.8274289999999382,10682,246419
"2001:14ba:a051:8c00:61b5:31a4:d1f8:cc83",56446,"2a05:d014:58f:6201::64",80,5,430,193,0,0,5,430,0,0,998.710652,15.03357200000005,228,0
"192.168.1.62",50898,"192.168.1.177",7680,8,531,194,0,0,5,357,3,174,1014.212948,0.0068280000000413565,418277,203866
"192.168.1.177",56449,"3.70.101.28",80,15,1268,195,0,0,8,553,7,715,1019.750366,67.94275599999992,65,84
"192.168.1.177",56450,"3.70.101.28",443,26,6536,196,0,0,14,1380,12,5156,1019.807686,67.88543599999991,162,607
"192.168.1.177",56452,"34.110.207.168",443,28,4005,197,0,0,15,2416,13,1589,1037.56073,170.7546890000001,113,74
"192.168.1.177",56455,"157.124.1.11",443,31,27944,198,0,0,16,6258,15,21686,1050.142138,0.8900230000001557,56250,194925
"2001:14ba:a051:8c00:61b5:31a4:d1f8:cc83",56456,"2a02:26f0:1200:5ac::1b01",80,5,430,199,0,0,5,430,0,0,1050.249695,15.040883000000122,228,0
"192.168.1.177",56457,"23.72.246.32",80,33,4342,200,0,0,17,1375,16,2967,1050.541055,115.72602200000006,95,205
"192.168.1.177",56458,"157.124.1.11",443,4,252,201,0,0,1,66,3,186,1051.00686,9.026589999999942,58,164
"192.168.1.177",56459,"157.124.1.11",443,116,75291,202,0,0,55,32746,61,42545,1051.446793,123.84724899999992,2115,2748
"192.168.1.177",56460,"157.124.1.11",443,173,214609,203,0,0,66,35309,107,179300,1051.62454,124.66941199999997,2265,11505
"192.168.1.177",56461,"157.124.1.11",443,56,20090,204,0,0,27,9254,29,10836,1051.890465,116.39527300000009,636,744
"192.168.1.177",56462,"157.124.1.11",443,55,20080,205,0,0,28,9343,27,10737,1051.895145,123.39881800000012,605,696
"192.168.1.177",56463,"157.124.1.11",443,56,20023,206,0,0,28,9275,28,10748,1051.899838,116.38941699999987,637,738
"192.168.1.177",56464,"157.124.1.11",443,44,11679,207,0,0,22,4299,22,7380,1052.638369,115.65045000000009,297,510
"192.168.1.62",50930,"192.168.1.177",7680,8,531,208,0,0,5,357,3,174,1054.216114,0.03279899999984082,87075,42440
"192.168.1.177",56466,"23.72.246.32",80,6,348,209,0,0,4,228,2,120,1071.292698,5.2367249999999785,348,183
"192.168.1.177",56468,"162.55.83.113",443,91,21305,210,0,0,45,8076,46,13229,1072.079154,184.20605499999988,350,574
"192.168.1.62",50950,"192.168.1.177",7680,8,531,211,0,0,5,357,3,174,1094.225172,0.008663000000069587,329677,160683
"192.168.1.177",56471,"149.154.167.99",443,52,20265,212,0,0,29,3523,23,16742,1104.488392,413.85583799999995,68,323
"192.168.1.177",56473,"149.154.167.99",443,68,136041,213,0,0,30,4203,38,131838,1104.61324,30.44332300000019,1104,34644
"192.168.1.177",56476,"34.117.237.239",443,33,4707,214,0,0,17,2758,16,1949,1132.107076,171.1488240000001,128,91
"192.168.1.62",50957,"192.168.1.177",7680,8,531,215,0,0,5,357,3,174,1134.23543,0.005771000000095228,494888,241206
"192.168.1.177",56479,"40.114.177.156",443,38,10599,216,0,0,16,2804,22,7795,1155.742745,20.755020999999942,1080,3004
"192.168.1.177",56480,"130.233.229.20",443,39,88856,217,0,0,14,3544,25,85312,1156.758152,0.321760999999924,88115,2121127
"192.168.1.177",56481,"34.120.208.123",443,22,5645,218,0,0,10,1093,12,4552,1157.076709,0.04401700000016717,198650,827316
"192.168.1.177",56482,"34.120.208.123",443,48,8249,219,0,0,24,5204,24,3045,1157.077577,171.21196499999996,243,142
"192.168.1.177",56483,"130.233.229.20",443,7,462,220,0,0,1,66,6,396,1157.086027,31.565155999999888,16,100
"192.168.1.177",56484,"52.85.49.37",443,40,10202,221,0,0,19,2450,21,7752,1157.177706,171.1195170000001,114,362
"2001:14ba:a051:8c00:61b5:31a4:d1f8:cc83",56485,"2a02:6ea0:c500::3",443,1,86,222,0,0,1,86,0,0,1157.217883,0,"",""
"192.168.1.177",56486,"185.76.9.23",443,38,13506,223,0,0,19,2444,19,11062,1157.480629,170.59719500000006,114,518
"192.168.1.177",56487,"130.233.229.20",443,17,5624,224,0,0,8,2839,9,2785,1157.563915,0.022558000000117318,1006826,987676
"192.168.1.177",56488,"130.233.229.20",443,19,8025,225,0,0,10,3039,9,4986,1158.792423,4.0285959999998795,6034,9901
"192.168.1.177",56489,"130.233.224.114",443,77,72225,226,0,0,38,28565,39,43660,1158.87603,9.935750000000098,22999,35153
"2001:14ba:a051:8c00:61b5:31a4:d1f8:cc83",56491,"2603:1026:3000:108::4",443,5,430,227,0,0,5,430,0,0,1162.195265,15.02187200000003,228,0
"192.168.1.177",56492,"20.190.181.0",443,103,90884,228,0,0,54,42498,49,48386,1162.445517,129.33710299999984,2628,2992
"192.168.1.177",56493,"130.233.0.8",443,93,89052,229,0,0,55,43742,38,45310,1162.943948,116.79880899999989,2996,3103
"2001:14ba:a051:8c00:61b5:31a4:d1f8:cc83",56494,"2606:4700::6812:e65",80,5,430,230,0,0,5,430,0,0,1163.01831,15.029927000000043,228,0
"192.168.1.177",56495,"104.18.15.101",80,32,3558,231,0,0,17,1382,15,2176,1163.309603,115.42357700000002,95,150
"192.168.1.177",56496,"216.58.209.170",443,29,8981,232,0,0,13,2199,16,6782,1163.533468,0.24893599999995786,70668,217951
"192.168.1.62",50968,"192.168.1.177",7680,8,531,233,0,0,5,357,3,174,1174.251734,0.006896999999980835,414093,201826
"192.168.1.177",56498,"130.233.224.114",443,51,51996,234,0,0,25,13998,26,37998,1176.253867,5.754149000000098,19461,52828
"192.168.1.177",56499,"130.233.229.20",443,93,235333,235,0,0,48,36631,45,198702,1177.068934,1.3220290000001569,221665,1202406
"192.168.1.177",56500,"130.233.229.20",443,7,462,236,0,0,1,66,6,396,1178.39097,31.765503999999964,16,99
"192.168.1.177",56501,"130.233.229.20",443,7,462,237,0,0,1,66,6,396,1178.430906,31.72556799999984,16,99
"192.168.1.177",56502,"130.233.229.20",443,7,462,238,0,0,1,66,6,396,1178.431236,31.72523799999999,16,99
"192.168.1.177",56503,"130.233.229.20",443,33,57045,239,0,0,14,2950,19,54095,1179.515407,4.646669999999858,5078,93133
"2001:14ba:a051:8c00:61b5:31a4:d1f8:cc83",56505,"2603:1026:3000:110::2",443,5,430,240,0,0,5,430,0,0,1183.225533,15.03503999999998,228,0
"192.168.1.177",56506,"104.18.15.101",80,6,348,241,0,0,4,228,2,120,1184.052708,5.426051000000143,336,176
"192.168.1.177",56508,"130.233.229.20",443,64,234760,242,0,0,22,6076,42,228684,1195.411158,7.060537000000068,6884,259112
"192.168.1.177",56509,"130.233.229.20",443,20,4526,243,0,0,10,3001,10,1525,1198.008875,4.47166900000002,5368,2728
"2001:14ba:a051:8c00:61b5:31a4:d1f8:cc83",56511,"2603:1026:3000:110::5",443,5,430,244,0,0,5,430,0,0,1204.273671,15.016206000000011,229,0
"192.168.1.62",50977,"192.168.1.177",7680,8,531,245,0,0,5,357,3,174,1214.252449,0.008166999999957625,349700,170442
"192.168.1.177",56513,"130.233.229.20",443,40,177971,246,0,0,18,4555,22,173416,1220.467058,6.255832000000055,5824,221765
"2001:14ba:a051:8c00:61b5:31a4:d1f8:cc83",56514,"2603:1026:3000:108::3",443,5,430,247,0,0,5,430,0,0,1225.294856,15.02802900000006,228,0
"192.168.1.177",56517,"130.233.229.20",443,53,368331,248,0,0,22,3778,31,364553,1243.932678,4.125213000000031,7326,706975
"192.168.1.177",56518,"20.190.181.0",443,14,5921,249,0,0,8,1306,6,4615,1246.337059,5.827766000000111,1792,6335
"2001:14ba:a051:8c00:61b5:31a4:d1f8:cc83",56519,"2a00:1450:4026:802::200e",443,1,86,250,0,0,1,86,0,0,1246.496535,0,"",""
"192.168.1.177",56520,"216.58.209.174",443,39,11992,251,0,0,20,2873,19,9119,1246.755763,172.0878570000002,133,423
"192.168.1.177",56521,"216.58.211.227",80,32,3035,252,0,0,17,1379,15,1656,1246.839348,115.38088800000014,95,114
"192.168.1.62",50987,"192.168.1.177",7680,8,531,253,0,0,5,357,3,174,1254.268292,0.00638400000002548,447368,218045
"192.168.1.177",56523,"34.120.52.64",443,66,12743,254,0,0,31,7178,35,5565,1258.633833,172.46376599999985,332,258
"192.168.1.177",56525,"162.55.98.14",443,902,242493,255,0,0,433,135907,469,106586,1261.82312,914.7262740000001,1188,932
"192.168.1.177",50102,"195.148.124.36",80,10,1226,256,0,0,6,504,4,722,1268.428255,0.009857999999894673,409007,585920
"192.168.1.177",50110,"188.166.241.168",80,10,1228,257,0,0,6,505,4,723,1275.162637,0.8449640000001182,4781,6845
"192.168.1.62",51008,"192.168.1.177",7680,8,531,258,0,0,5,357,3,174,1294.282387,0.009362000000010084,305063,148686
"192.168.1.177",56530,"130.233.229.20",443,19,4419,259,0,0,10,2932,9,1487,1295.727599,4.077972999999929,5751,2917
"192.168.1.62",51011,"192.168.1.177",7680,8,531,260,0,0,5,357,3,174,1334.296562,0.006018000000040047,474576,231306
"192.168.1.62",51019,"192.168.1.177",7680,8,531,261,0,0,5,357,3,174,1374.302646,0.007500999999820124,380749,185575
"192.168.1.62",51031,"192.168.1.177",7680,8,531,262,0,0,5,357,3,174,1414.30353,0.0073220000001583685,390057,190111
"192.168.1.177",56544,"149.154.167.99",443,76,197810,263,0,0,36,4998,40,192812,1429.084599,42.51088400000003,940,36284
"192.168.1.62",51045,"192.168.1.177",7680,8,531,264,0,0,5,357,3,174,1454.313927,0.005258000000139873,543172,264739
"192.168.1.177",56548,"34.120.52.64",443,79,15517,265,0,0,36,5825,43,9692,1466.571034,300.05477499999984,155,258
"192.168.1.62",51083,"192.168.1.177",7680,8,531,266,0,0,5,357,3,174,1494.32354,0.005195999999841661,549653,267898
"192.168.1.177",56555,"149.154.167.99",443,37,10053,267,0,0,18,2356,19,7697,1532.035646,170.533819,110,361
"192.168.1.62",51098,"192.168.1.177",7680,8,531,268,0,0,5,357,3,174,1534.33039,0.007061999999905311,404418,197111
"192.168.1.62",51137,"192.168.1.177",7680,8,531,269,0,0,5,357,3,174,1574.342403,0.0063289999998232815,451256,219939
"192.168.1.177",56563,"34.110.207.168",443,28,4005,270,0,0,15,2416,13,1589,1601.066196,170.54248899999993,113,74
"192.168.1.177",56564,"34.110.207.168",443,56,9144,271,0,0,29,6016,27,3128,1601.109082,456.92429300000003,105,54
"192.168.1.177",56566,"149.154.167.99",443,71,102691,272,0,0,23,4033,48,98658,1611.999198,30.400435000000016,1061,25962
"192.168.1.62",51153,"192.168.1.177",7680,8,531,273,0,0,5,357,3,174,1614.34735,0.012261000000080458,232933,113530
"2001:14ba:a051:8c00:61b5:31a4:d1f8:cc83",56569,"2a02:26f0:5200::b81f:f89",443,1,86,274,0,0,1,86,0,0,1636.923975,0,"",""
"192.168.1.177",56570,"2.22.244.241",443,32,12464,275,0,0,16,3626,16,8838,1637.224902,60.17930999999999,482,1174
"192.168.1.62",51178,"192.168.1.177",7680,8,531,276,0,0,5,357,3,174,1654.365516,0.008517999999867243,335289,163418
"192.168.1.62",51184,"192.168.1.177",7680,8,531,277,0,0,5,357,3,174,1694.369704,0.009479000000055748,301297,146850
"2001:14ba:a051:8c00:61b5:31a4:d1f8:cc83",56576,"2a02:3d0:640:a000::",80,1,86,278,0,0,1,86,0,0,1697.347792,0,"",""
"192.168.1.177",56577,"178.79.212.129",80,11,1152,279,0,0,6,618,5,534,1697.653226,60.03625299999999,82,71
"192.168.1.177",56581,"40.114.178.124",443,35,8629,280,0,0,15,2295,20,6334,1730.223613,20.129663000000164,912,2517
"192.168.1.62",51198,"192.168.1.177",7680,8,531,281,0,0,5,357,3,174,1734.396192,0.011791000000130225,242218,118056
"192.168.1.177",56585,"216.58.211.234",443,33,39254,282,0,0,16,3077,17,36177,1757.308045,0.22726000000011481,108316,1273501
"192.168.1.177",56587,"34.120.52.64",443,690,450679,283,0,0,260,34641,430,416038,1768.017923,932.8221820000001,297,3567
"2001:14ba:a051:8c00:61b5:31a4:d1f8:cc83",56588,"2a05:d014:58f:6202::64",80,5,430,284,0,0,5,430,0,0,1768.91535,15.023648999999978,228,0
"192.168.1.177",56589,"34.117.138.150",443,32,8241,285,0,0,17,2016,15,6225,1772.227186,170.35214999999994,94,292
"192.168.1.177",56590,"34.117.138.150",443,18,7276,286,0,0,8,1399,10,5877,1772.228341,0.05547999999998865,201730,847440
"192.168.1.177",56591,"34.117.138.150",443,20,7384,287,0,0,9,1453,11,5931,1772.228858,0.056377000000111366,206183,841619
"192.168.1.177",56592,"34.117.138.150",443,20,7384,288,0,0,9,1453,11,5931,1772.229188,0.055824999999913416,208222,849941
"192.168.1.177",56593,"34.117.138.150",443,21,7438,289,0,0,10,1507,11,5931,1772.229579,0.055433999999877415,217483,855936
"192.168.1.62",51210,"192.168.1.177",7680,8,531,290,0,0,5,357,3,174,1774.395053,0.006294000000025335,453765,221163
"192.168.1.177",56595,"40.127.240.158",443,23,7279,291,0,0,12,2178,11,5101,1786.679573,0.3780330000001868,46091,107948
"2001:14ba:a051:8c00:61b5:31a4:d1f8:cc83",56597,"2a05:d014:58f:6201::64",80,5,430,292,0,0,5,430,0,0,1789.948931,15.035358000000087,228,0
"192.168.1.177",56598,"149.154.167.99",443,40,10889,293,0,0,21,3160,19,7729,1795.249062,207.4917019999998,121,297
"192.168.1.177",56599,"149.154.167.99",443,63,111689,294,0,0,23,3825,40,107864,1795.360591,30.475082999999813,1004,28315
"192.168.1.177",56602,"3.70.101.28",80,15,1268,295,0,0,8,553,7,715,1810.999564,67.94436199999996,65,84
"192.168.1.177",56603,"3.70.101.28",443,26,6538,296,0,0,14,1380,12,5158,1811.055689,67.88823699999989,162,607
"192.168.1.62",51217,"192.168.1.177",7680,8,531,297,0,0,5,357,3,174,1814.407016,0.008304999999836582,343889,167609
"192.168.1.62",51240,"192.168.1.177",7680,8,531,298,0,0,5,357,3,174,1854.412032,0.006752000000005864,422985,206161
"192.168.1.177",50062,"195.148.124.36",80,10,1226,299,0,0,6,504,4,722,1868.409292,0.012230000000045038,329681,472281
"192.168.1.177",56609,"192.229.221.95",80,14,3954,300,0,0,8,1407,6,2547,1871.187072,60.072192000000086,187,339
"192.168.1.177",50066,"188.166.241.168",80,10,1228,301,0,0,6,505,4,723,1875.082086,0.839886000000206,4810,6886
"192.168.1.62",51248,"192.168.1.177",7680,8,531,302,0,0,5,357,3,174,1894.427676,0.006225000000085856,458795,223614
"2001:14ba:a051:8c00:61b5:31a4:d1f8:cc83",56617,"2001:14b8:1800:303::3ea5:9f29",443,1,86,303,0,0,1,86,0,0,1926.822164,0,"",""
"2001:14ba:a051:8c00:61b5:31a4:d1f8:cc83",56618,"2001:14b8:1800:303::3ea5:9f29",443,1,86,304,0,0,1,86,0,0,1927.073901,0,"",""
"2001:14ba:a051:8c00:61b5:31a4:d1f8:cc83",56619,"2001:14b8:1800:303::3ea5:9f29",443,1,86,305,0,0,1,86,0,0,1927.120547,0,"",""
"2001:14ba:a051:8c00:61b5:31a4:d1f8:cc83",56620,"2001:14b8:1800:303::3ea5:9f29",443,1,86,306,0,0,1,86,0,0,1927.121413,0,"",""
"2001:14ba:a051:8c00:61b5:31a4:d1f8:cc83",56621,"2001:14b8:1800:303::3ea5:9f29",443,1,86,307,0,0,1,86,0,0,1927.122298,0,"",""
"2001:14ba:a051:8c00:61b5:31a4:d1f8:cc83",56622,"2001:14b8:1800:303::3ea5:9f29",443,1,86,308,0,0,1,86,0,0,1927.12398,0,"",""
"192.168.1.177",56623,"62.165.159.8",443,129,287202,309,0,0,33,3578,96,283624,1927.125106,133.71899699999994,214,16968
"192.168.1.177",56624,"62.165.159.8",443,18,2270,310,0,0,8,1120,10,1150,1927.436132,100.0321919999999,89,91
"2001:14ba:a051:8c00:61b5:31a4:d1f8:cc83",56625,"2a04:4e42:3a::760",443,1,86,311,0,0,1,86,0,0,1930.704609,0,"",""
"2001:14ba:a051:8c00:61b5:31a4:d1f8:cc83",56626,"2a04:4e42:3a::760",443,1,86,312,0,0,1,86,0,0,1930.72118,0,"",""
"2001:14ba:a051:8c00:61b5:31a4:d1f8:cc83",56627,"2a04:4e42:3a::760",443,1,86,313,0,0,1,86,0,0,1930.721472,0,"",""
"2001:14ba:a051:8c00:61b5:31a4:d1f8:cc83",56628,"2a04:4e42:3a::760",443,1,86,314,0,0,1,86,0,0,1930.953369,0,"",""
"2001:14ba:a051:8c00:61b5:31a4:d1f8:cc83",56629,"2a04:4e42:3a::760",443,1,86,315,0,0,1,86,0,0,1930.968333,0,"",""
"192.168.1.177",56630,"151.101.246.248",443,33,16297,316,0,0,15,2063,18,14234,1931.01392,328.2136519999997,50,346
"192.168.1.177",56631,"151.101.246.248",443,50,39285,317,0,0,19,3231,31,36054,1931.02899,328.19877599999995,78,878
"192.168.1.177",56632,"151.101.246.248",443,37,42453,318,0,0,17,2249,20,40204,1931.029142,328.19854699999973,54,979
"192.168.1.177",56633,"151.101.246.248",443,21,1972,319,0,0,10,1125,11,847,1931.263219,193.50041099999999,46,35
"192.168.1.177",56634,"151.101.246.248",443,21,1971,320,0,0,10,1124,11,847,1931.278097,193.48079800000005,46,35
"2001:14ba:a051:8c00:61b5:31a4:d1f8:cc83",56636,"2001:14b8:1800:303::3ea5:9f08",443,1,86,321,0,0,1,86,0,0,1933.395844,0,"",""
"2001:14ba:a051:8c00:61b5:31a4:d1f8:cc83",56637,"2a04:4e42:3a::760",443,1,86,322,0,0,1,86,0,0,1933.492335,0,"",""
"2001:14ba:a051:8c00:61b5:31a4:d1f8:cc83",56638,"2001:14b8:1800:303::3ea5:9f08",443,1,86,323,0,0,1,86,0,0,1933.642923,0,"",""
"2001:14ba:a051:8c00:61b5:31a4:d1f8:cc83",56639,"2001:14b8:1800:303::3ea5:9f08",443,1,86,324,0,0,1,86,0,0,1933.689236,0,"",""
"2001:14ba:a051:8c00:61b5:31a4:d1f8:cc83",56640,"2001:14b8:1800:303::3ea5:9f08",443,1,86,325,0,0,1,86,0,0,1933.689524,0,"",""
"2001:14ba:a051:8c00:61b5:31a4:d1f8:cc83",56641,"2001:14b8:1800:303::3ea5:9f08",443,1,86,326,0,0,1,86,0,0,1933.689819,0,"",""
"2001:14ba:a051:8c00:61b5:31a4:d1f8:cc83",56642,"2001:14b8:1800:303::3ea5:9f08",443,1,86,327,0,0,1,86,0,0,1933.690032,0,"",""
"192.168.1.177",56643,"62.165.159.41",443,225,402603,328,0,0,97,9199,128,393404,1933.697089,127.09184500000015,579,24763
"2001:14ba:a051:8c00:61b5:31a4:d1f8:cc83",56644,"2a04:4e42:3a::760",443,1,86,329,0,0,1,86,0,0,1933.743684,0,"",""
"192.168.1.177",56645,"151.101.246.248",443,38,23250,330,0,0,17,2376,21,20874,1933.829827,325.39816800000017,58,513
"192.168.1.177",56646,"151.101.246.248",443,21,1971,331,0,0,10,1124,11,847,1934.045935,190.7131119999999,47,35
"192.168.1.62",51254,"192.168.1.177",7680,8,531,332,0,0,5,357,3,174,1934.433896,0.012676000000055865,225307,109813
"2001:14ba:a051:8c00:61b5:31a4:d1f8:cc83",56647,"2a04:4e42:3a::760",443,1,86,333,0,0,1,86,0,0,1935.294997,0,"",""
"2001:14ba:a051:8c00:61b5:31a4:d1f8:cc83",56648,"2a04:4e42:3a::760",443,1,86,334,0,0,1,86,0,0,1935.397133,0,"",""
"2001:14ba:a051:8c00:61b5:31a4:d1f8:cc83",56649,"2a04:4e42:3a::760",443,1,86,335,0,0,1,86,0,0,1935.534793,0,"",""
"192.168.1.177",56650,"151.101.246.248",443,89,275115,336,0,0,29,2828,60,272287,1935.596897,389.8953580000002,58,5586
"2001:14ba:a051:8c00:61b5:31a4:d1f8:cc83",56651,"2a04:4e42:3a::760",443,1,86,337,0,0,1,86,0,0,1935.641712,0,"",""
"192.168.1.177",56652,"151.101.246.248",443,4329,25587949,338,0,0,1500,116291,2829,25471658,1935.701538,1099.441901,846,185342
"192.168.1.177",56653,"151.101.246.248",443,21,1971,339,0,0,10,1124,11,847,1935.835434,188.4208319999998,47,35
"192.168.1.177",56654,"151.101.246.248",443,21,1971,340,0,0,10,1124,11,847,1935.942715,188.31361500000025,47,35
"192.168.1.62",51264,"192.168.1.177",7680,8,531,341,0,0,5,357,3,174,1974.44042,0.009358000000020184,305193,148749
"2001:14ba:a051:8c00:61b5:31a4:d1f8:cc83",56659,"2001:b28:f23d:8007::805:532",443,5,430,342,0,0,5,430,0,0,1977.768031,15.023185999999896,228,0
"192.168.1.177",56660,"149.154.174.200",443,56,47910,343,0,0,20,3310,36,44600,1978.032078,32.41099000000008,817,11008
"192.168.1.177",56663,"149.154.174.200",443,16,2861,344,0,0,8,1854,8,1007,1998.80895,0.4379789999998138,33864,18393
"192.168.1.62",51306,"192.168.1.177",7680,8,531,345,0,0,5,357,3,174,2014.454756,0.006161000000020067,463561,225937
"192.168.1.177",56667,"34.117.237.239",443,32,4653,346,0,0,17,2758,15,1895,2032.493198,171.33517499999994,128,88
"192.168.1.177",56669,"149.154.167.99",443,42,11053,347,0,0,23,3307,19,7746,2046.846891,256.1503290000003,103,241
"192.168.1.177",56670,"149.154.167.99",443,43,38167,348,0,0,20,3679,23,34488,2046.959787,30.318395999999893,970,9100
"192.168.1.62",51325,"192.168.1.177",7680,8,531,349,0,0,5,357,3,174,2054.466705,0.007278000000042084,392415,191261
"192.168.1.62",51341,"192.168.1.177",7680,8,531,350,0,0,5,357,3,174,2094.478526,0.008937000000059925,319570,155756
"2001:14ba:a051:8c00:61b5:31a4:d1f8:cc83",56678,"2001:14b8:1800:303::3ea5:9f29",443,1,86,351,0,0,1,86,0,0,2124.26903,0,"",""
"2001:14ba:a051:8c00:61b5:31a4:d1f8:cc83",56679,"2001:14b8:1800:303::3ea5:9f29",443,1,86,352,0,0,1,86,0,0,2124.506904,0,"",""
"192.168.1.177",56680,"62.165.159.41",443,91,252122,353,0,0,24,2386,67,249736,2124.571882,120.01800099999991,159,16646
"2001:14ba:a051:8c00:61b5:31a4:d1f8:cc83",56681,"2001:14b8:1800:303::3ea5:9f08",443,1,86,354,0,0,1,86,0,0,2124.768023,0,"",""
"192.168.1.177",56682,"62.165.159.41",443,18,2270,355,0,0,8,1120,10,1150,2124.821838,100.0205920000003,89,91
"2001:14ba:a051:8c00:61b5:31a4:d1f8:cc83",56683,"2001:14b8:1800:303::3ea5:9f08",443,1,86,356,0,0,1,86,0,0,2125.008521,0,"",""
"192.168.1.177",56684,"62.165.159.8",443,42,87176,357,0,0,15,2060,27,85116,2125.070092,120.02650600000015,137,5673
"192.168.1.177",56685,"62.165.159.8",443,18,2270,358,0,0,8,1120,10,1150,2125.318095,100.02361399999972,89,91
"192.168.1.62",51356,"192.168.1.177",7680,8,531,359,0,0,5,357,3,174,2134.479473,0.010900000000219734,262018,127706
"192.168.1.62",51363,"192.168.1.177",7680,8,531,360,0,0,5,357,3,174,2174.488238,0.006112999999913882,467201,227711
"192.168.1.177",56694,"34.120.208.123",443,42,9849,361,0,0,21,3633,21,6216,2213.678524,171.04789100000016,169,290
"192.168.1.62",51366,"192.168.1.177",7680,8,531,362,0,0,5,357,3,174,2214.491953,0.006150999999590567,464314,226304
"192.168.1.177",56698,"149.154.170.200",443,41,27596,363,0,0,15,2832,26,24764,2250.573448,31.51646099999971,718,6285
"192.168.1.62",51391,"192.168.1.177",7680,8,531,364,0,0,5,357,3,174,2254.499447,0.006680999999844062,427480,208352
"2001:14ba:a051:8c00:61b5:31a4:d1f8:cc83",56700,"2600:1901:1:81::",443,1,86,365,0,0,1,86,0,0,2259.240794,0,"",""
"2001:14ba:a051:8c00:61b5:31a4:d1f8:cc83",56701,"2600:1901:1:81::",443,1,86,366,0,0,1,86,0,0,2259.484656,0,"",""
"192.168.1.177",56702,"35.186.224.17",443,1669,314016,367,0,0,802,226947,867,87069,2259.546038,3659.7436430000002,496,190
"192.168.1.177",56703,"35.186.224.17",443,14,2206,368,0,0,8,1092,6,1114,2259.795444,65.93273200000021,132,135
"192.168.1.177",56705,"149.154.167.99",443,38,28585,369,0,0,17,3517,21,25068,2272.185845,30.34823899999992,927,6608
"192.168.1.62",51405,"192.168.1.177",7680,8,531,370,0,0,5,357,3,174,2294.505144,0.007045999999718333,405336,197558
"192.168.1.177",56709,"94.130.182.214",443,238,71359,371,0,0,123,41416,115,29943,2299.609792,273.12837599999966,1213,877
"2001:14ba:a051:8c00:61b5:31a4:d1f8:cc83",56712,"2001:14b8:1800:303::3ea5:9f08",443,1,86,372,0,0,1,86,0,0,2325.499139,0,"",""
"2001:14ba:a051:8c00:61b5:31a4:d1f8:cc83",56713,"2001:14b8:1800:303::3ea5:9f08",443,1,86,373,0,0,1,86,0,0,2325.744146,0,"",""
"2001:14ba:a051:8c00:61b5:31a4:d1f8:cc83",56714,"2001:14b8:1800:303::3ea5:9f29",443,1,86,374,0,0,1,86,0,0,2325.754659,0,"",""
"192.168.1.177",56715,"62.165.159.8",443,60,152665,375,0,0,19,2116,41,150549,2325.811154,120.01768799999991,141,10035
"2001:14ba:a051:8c00:61b5:31a4:d1f8:cc83",56716,"2001:14b8:1800:303::3ea5:9f29",443,1,86,376,0,0,1,86,0,0,2325.985261,0,"",""
"192.168.1.177",56717,"62.165.159.8",443,18,2270,377,0,0,8,1120,10,1150,2326.048779,100.03639399999975,89,91
"192.168.1.177",56718,"62.165.159.41",443,41,51785,378,0,0,13,1953,28,49832,2326.055673,120.02931100000023,130,3321
"192.168.1.177",56719,"62.165.159.41",443,18,2270,379,0,0,8,1120,10,1150,2326.296108,100.04194300000017,89,91
"192.168.1.62",51421,"192.168.1.177",7680,8,531,380,0,0,5,357,3,174,2334.516387,0.007271999999829859,392739,191419
"192.168.1.177",56722,"35.186.227.140",443,524,157426,381,0,0,225,124225,299,33201,2343.109025,704.8598569999999,1409,376
"192.168.1.177",56723,"34.110.207.168",443,78,12454,382,0,0,41,8454,37,4000,2343.14291,691.7957160000001,97,46
"192.168.1.177",56725,"149.154.167.99",443,1200,1305814,383,0,0,684,92614,516,1213200,2358.089009,616.3811180000002,1202,15746
"192.168.1.177",56726,"149.154.167.99",443,50,51412,384,0,0,23,4104,27,47308,2358.205037,45.45334199999979,722,8326
"192.168.1.62",51438,"192.168.1.177",7680,8,531,385,0,0,5,357,3,174,2374.521267,0.007180000000062137,397771,193871
"192.168.1.177",56731,"20.54.232.160",443,38,23443,386,0,0,21,11010,17,12433,2405.197439,170.2428789999999,517,584
"192.168.1.62",51454,"192.168.1.177",7680,8,531,387,0,0,5,357,3,174,2414.525847,0.005623999999897933,507823,247510
"192.168.1.177",56734,"149.154.167.99",443,37,24653,388,0,0,18,3571,19,21082,2418.419861,30.35496200000034,941,5556
"192.168.1.177",56736,"157.240.205.60",443,40,8866,389,0,0,20,2498,20,6368,2433.756856,170.639228,117,298
"192.168.1.177",56737,"142.132.209.32",443,24,7522,390,0,0,11,1575,13,5947,2435.02283,0.5195320000002539,24252,91574
"192.168.1.177",56738,"142.132.209.32",443,40,10380,391,0,0,17,2995,23,7385,2435.023199,42.01601999999957,570,1406
"192.168.1.177",56739,"142.132.209.32",443,25,7598,392,0,0,11,1575,14,6023,2435.023507,0.5134140000000116,24541,93850
"192.168.1.177",56740,"62.183.170.50",80,32,3217,393,0,0,17,1375,15,1842,2435.167601,115.45144200000004,95,127
"192.168.1.177",56741,"62.183.170.50",80,32,3217,394,0,0,17,1375,15,1842,2435.167983,115.45103800000015,95,127
"192.168.1.177",56742,"62.183.170.50",80,32,3217,395,0,0,17,1375,15,1842,2435.168154,115.45082300000013,95,127
"2001:14ba:a051:8c00:61b5:31a4:d1f8:cc83",56743,"2606:4700:4400::6812:2439",443,1,86,396,0,0,1,86,0,0,2436.408647,0,"",""
"192.168.1.177",56744,"172.64.151.199",443,190,338572,397,0,0,71,12746,119,325826,2436.660099,176.83825699999989,576,14740
"2001:14ba:a051:8c00:61b5:31a4:d1f8:cc83",56746,"2a01:4f8:c012:e655::1",443,1,86,398,0,0,1,86,0,0,2442.077228,0,"",""
"2001:14ba:a051:8c00:61b5:31a4:d1f8:cc83",56747,"2a01:4f8:c012:e655::1",443,1,86,399,0,0,1,86,0,0,2442.077438,0,"",""
"192.168.1.177",56748,"91.107.148.202",443,47,11468,400,0,0,23,4474,24,6994,2442.328079,171.19846800000005,209,326
"192.168.1.177",56749,"91.107.148.202",443,19,6755,401,0,0,10,1499,9,5256,2442.328264,0.14373399999976755,83431,292540
"192.168.1.177",56751,"40.114.177.156",443,5,330,402,0,0,1,66,4,264,2451.253589,7.301312999999936,72,289
"192.168.1.177",56752,"40.114.177.156",443,66,17474,403,0,0,29,3538,37,13936,2451.332657,21.014549999999872,1346,5305
"192.168.1.177",56753,"40.114.177.156",443,163,133231,404,0,0,72,8221,91,125010,2452.446344,30.043521000000055,2189,33287
"192.168.1.177",56754,"40.114.177.156",443,39,11658,405,0,0,15,2219,24,9439,2452.625234,28.64460999999983,619,2636
"192.168.1.177",56755,"20.103.36.96",443,32,21164,406,0,0,16,2647,16,18517,2453.903802,28.48396300000013,743,5200
"192.168.1.62",51477,"192.168.1.177",7680,8,531,407,0,0,5,357,3,174,2454.531949,0.007464999999683641,382585,186470
"192.168.1.177",56756,"40.114.178.124",443,92,56905,408,0,0,45,5115,47,51790,2454.728357,29.301930000000084,1396,14139
"192.168.1.177",56757,"40.114.178.124",443,22,6867,409,0,0,10,1522,12,5345,2454.742901,0.3956709999997656,30773,108069
"192.168.1.177",56758,"40.114.178.124",443,23,6921,410,0,0,10,1522,13,5399,2454.743635,0.3988710000003266,30526,108285
"192.168.1.177",56759,"40.114.178.124",443,22,6867,411,0,0,10,1522,12,5345,2454.743988,0.382560999999896,31827,111773
"192.168.1.177",56760,"40.114.178.124",443,20,6759,412,0,0,10,1522,10,5237,2454.74437,0.16400400000020454,74242,255457
"192.168.1.177",56761,"40.114.178.124",443,23,6921,413,0,0,10,1522,13,5399,2454.744598,0.3979479999998148,30596,108536
"192.168.1.177",56763,"185.179.237.109",443,49,54220,414,0,0,24,5237,25,48983,2463.737743,5.628832999999759,7443,69617
"192.168.1.177",56764,"185.179.237.109",443,18,4754,415,0,0,10,2409,8,2345,2463.87516,5.498936999999842,3504,3411
"2001:14ba:a051:8c00:61b5:31a4:d1f8:cc83",56765,"2a00:1450:4026:804::200a",443,1,86,416,0,0,1,86,0,0,2463.90375,0,"",""
"2001:14ba:a051:8c00:61b5:31a4:d1f8:cc83",56766,"2a00:1450:4026:804::200a",443,1,86,417,0,0,1,86,0,0,2463.905375,0,"",""
"2001:14ba:a051:8c00:61b5:31a4:d1f8:cc83",56767,"2a00:1450:4026:804::200a",443,1,86,418,0,0,1,86,0,0,2463.907182,0,"",""
"192.168.1.177",56768,"216.58.211.234",443,19,7315,419,0,0,10,1494,9,5821,2464.158472,0.14560900000014954,82082,319815
"192.168.1.177",56769,"216.58.211.234",443,94,136452,420,0,0,36,4287,58,132165,2464.159135,187.44078900000022,182,5640
"192.168.1.177",56770,"216.58.211.234",443,17,7208,421,0,0,10,1494,7,5714,2464.160747,0.14326400000027206,83426,319075
"192.168.1.177",56771,"216.58.210.163",80,32,3033,422,0,0,17,1378,15,1655,2464.273955,115.722037,95,114
"192.168.1.177",56772,"216.58.210.163",80,32,3033,423,0,0,17,1378,15,1655,2464.274131,115.72213199999987,95,114
"192.168.1.177",56773,"216.58.210.163",80,32,3033,424,0,0,17,1378,15,1655,2464.274301,115.72178200000008,95,114
"192.168.1.177",50114,"195.148.124.36",5200,30,2741,425,0,0,17,1566,13,1175,2464.336607,10.44540599999982,1199,899
"192.168.1.177",50074,"195.148.124.36",80,1541,10588656,426,0,0,294,20334,1247,10568322,2464.338421,0.4235800000001291,384040,199600018
"192.168.1.177",50076,"195.148.124.36",5200,94345,120369075,427,0,0,78808,119308117,15537,1060958,2464.429569,10.26598100000001,92973573,826775
"192.168.1.177",50102,"188.166.241.168",80,2510,10655283,428,0,0,591,42609,1919,10612674,2464.76063,9.689924999999675,35177,8761821
"192.168.1.177",50110,"195.148.124.36",80,10,1226,429,0,0,6,504,4,722,2468.356141,0.025987999999870226,155148,222256
"192.168.1.177",50106,"195.148.124.138",443,27,9914,430,0,0,14,1664,13,8250,2468.387813,15.190696000000116,876,4344
"192.168.1.177",50142,"188.166.241.168",80,10,1228,431,0,0,6,505,4,723,2475.077578,0.840715000000273,4805,6879
"192.168.1.177",50090,"195.148.124.36",5204,31,2829,432,0,0,17,1582,14,1247,2475.0781,10.228185999999823,1237,975
"192.168.1.177",50100,"195.148.124.36",5204,25247,252554343,433,0,0,6692,443433,18555,252110910,2475.136768,10.165189000000282,348981,198411193
"192.168.1.177",56775,"185.179.237.109",443,36,8698,434,0,0,15,4565,21,4133,2479.272878,13.342413999999735,2737,2478
"192.168.1.177",56776,"185.179.237.109",443,20,4909,435,0,0,9,2858,11,2051,2479.274662,5.048145000000204,4529,3250
"2001:14ba:a051:8c00:61b5:31a4:d1f8:cc83",56777,"2001:14b8:1800:303::3ea5:9f08",443,1,86,436,0,0,1,86,0,0,2480.546457,0,"",""
"2001:14ba:a051:8c00:61b5:31a4:d1f8:cc83",56778,"2001:14b8:1800:303::3ea5:9f08",443,1,86,437,0,0,1,86,0,0,2480.768013,0,"",""
"2001:14ba:a051:8c00:61b5:31a4:d1f8:cc83",56779,"2001:14b8:1800:303::3ea5:9f29",443,1,86,438,0,0,1,86,0,0,2480.834229,0,"",""
"192.168.1.177",56780,"62.165.159.8",443,45,72815,439,0,0,18,2062,27,70753,2480.860628,120.03937300000007,137,4715
"192.168.1.177",56781,"62.165.159.8",443,19,2348,440,0,0,8,1132,11,1216,2481.078749,100.05565999999999,90,97
"2001:14ba:a051:8c00:61b5:31a4:d1f8:cc83",56782,"2001:14b8:1800:303::3ea5:9f29",443,1,86,441,0,0,1,86,0,0,2481.079048,0,"",""
"192.168.1.177",56783,"62.165.159.41",443,42,82355,442,0,0,15,2048,27,80307,2481.137055,120.02864599999975,136,5352
"192.168.1.177",56785,"62.165.159.41",443,20,2402,443,0,0,9,1186,11,1216,2481.389948,100.03808799999979,94,97
"192.168.1.177",50144,"188.166.241.168",5208,32,2863,444,0,0,18,1627,14,1236,2485.307546,13.186563000000206,987,749
"192.168.1.177",50152,"188.166.241.168",5208,3507,3739887,445,0,0,2427,3668731,1080,71156,2486.466251,11.09664100000009,2644930,51299
"192.168.1.177",50060,"195.148.124.138",443,29,10143,446,0,0,16,1796,13,8347,2487.601993,15.15625,947,4405
"192.168.1.177",56787,"185.179.237.109",443,40,9481,447,0,0,18,5520,22,3961,2493.156291,12.288042000000132,3593,2578
"192.168.1.62",51497,"192.168.1.177",7680,8,531,448,0,0,5,357,3,174,2494.539976,0.006718000000091706,425126,207204
"192.168.1.177",50096,"188.166.241.168",5204,32,2865,449,0,0,18,1645,14,1220,2498.229874,13.21189299999969,996,738
"192.168.1.177",50098,"188.166.241.168",5204,7714,53789601,450,0,0,1631,111067,6083,53678534,2499.393973,11.762185999999929,75541,36509223
"192.168.1.177",50086,"195.148.124.138",443,26,9835,451,0,0,14,1664,12,8171,2506.774217,12.631837999999789,1053,5174
"192.168.1.177",56790,"185.179.237.109",443,46,11002,452,0,0,19,6185,27,4817,2506.974349,15.286555000000135,3236,2520
"192.168.1.62",51529,"192.168.1.177",7680,8,531,453,0,0,5,357,3,174,2534.555801,0.005364000000099622,532438,259507
"192.168.1.177",56794,"34.120.208.123",443,48,9158,454,0,0,23,5693,25,3465,2537.131325,170.50463400000035,267,162
"192.168.1.177",56796,"216.58.209.174",443,37,11964,455,0,0,20,2956,17,9008,2542.348469,170.30058999999983,138,423
"2001:14ba:a051:8c00:61b5:31a4:d1f8:cc83",56799,"2a05:d014:58f:6200::64",80,5,430,456,0,0,5,430,0,0,2560.234674,15.021613000000343,229,0
"192.168.1.177",56800,"149.154.167.99",443,41,23371,457,0,0,17,3677,24,19694,2563.387248,30.32261100000005,970,5195
"192.168.1.62",51571,"192.168.1.177",7680,8,531,458,0,0,5,357,3,174,2574.570027,0.006037999999989552,473004,230539
"2001:14ba:a051:8c00:61b5:31a4:d1f8:cc83",56802,"2a05:d014:275:cb01::c8",80,5,430,459,0,0,5,430,0,0,2581.270754,15.036267999999836,228,0
"192.168.1.177",56805,"213.239.220.37",443,156,34791,460,0,0,73,14060,83,20731,2600.256837,361.19766400000026,311,459
"192.168.1.177",56806,"3.72.140.173",80,15,1268,461,0,0,8,553,7,715,2602.3219,67.88881600000013,65,84
"192.168.1.177",56807,"3.72.140.173",443,26,6536,462,0,0,14,1380,12,5156,2602.377085,67.83395699999983,162,608
"192.168.1.177",56808,"149.154.167.99",443,272,559699,463,0,0,155,144128,117,415571,2602.490995,93.29603999999972,12358,35634
"192.168.1.177",56810,"149.154.167.99",443,297,288246,464,0,0,237,277827,60,10419,2606.387973,30.490035000000262,72896,2733
"192.168.1.177",56811,"149.154.167.99",443,195,180781,465,0,0,155,177299,40,3482,2606.517469,30.37556799999993,46695,917
"2001:14ba:a051:8c00:61b5:31a4:d1f8:cc83",56812,"2001:14b8:1800:303::3ea5:9f08",443,1,86,466,0,0,1,86,0,0,2612.275281,0,"",""
"2001:14ba:a051:8c00:61b5:31a4:d1f8:cc83",56813,"2001:14b8:1800:303::3ea5:9f08",443,1,86,467,0,0,1,86,0,0,2612.520541,0,"",""
"192.168.1.177",56814,"62.165.159.41",443,55,191467,468,0,0,22,2358,33,189109,2612.589664,120.020489,157,12605
"2001:14ba:a051:8c00:61b5:31a4:d1f8:cc83",56815,"2001:14b8:1800:303::3ea5:9f29",443,1,86,469,0,0,1,86,0,0,2612.74479,0,"",""
"192.168.1.177",56816,"62.165.159.41",443,18,2270,470,0,0,8,1120,10,1150,2612.825509,100.0386410000001,89,91
"2001:14ba:a051:8c00:61b5:31a4:d1f8:cc83",56817,"2001:14b8:1800:303::3ea5:9f29",443,1,86,471,0,0,1,86,0,0,2612.997853,0,"",""
"192.168.1.177",56818,"62.165.159.8",443,38,41856,472,0,0,15,2048,23,39808,2613.059783,120.033144,136,2653
"192.168.1.177",56819,"62.165.159.8",443,18,2270,473,0,0,8,1120,10,1150,2613.308939,100.03872499999989,89,91
"192.168.1.62",51602,"192.168.1.177",7680,8,531,474,0,0,5,357,3,174,2614.575321,0.005920000000060099,482432,235135
"192.168.1.62",51611,"192.168.1.177",7680,8,531,475,0,0,5,357,3,174,2654.57689,0.010511000000406057,271715,132432
"192.168.1.177",56825,"52.184.216.226",443,24,5738,476,0,0,14,2085,10,3653,2663.623545,96.87484200000017,172,301
"192.168.1.62",51638,"192.168.1.177",7680,8,531,477,0,0,5,357,3,174,2694.582626,0.007159000000228843,398938,194440
"192.168.1.177",56832,"216.58.211.234",443,29,5092,478,0,0,13,2774,16,2318,2732.981145,0.23341499999969528,95075,79446
"192.168.1.177",56833,"216.58.211.234",443,29,5091,479,0,0,13,2773,16,2318,2732.982025,0.23247300000002724,95426,79768
"192.168.1.62",51657,"192.168.1.177",7680,8,531,480,0,0,5,357,3,174,2734.594889,0.024574000000029628,116220,56645
"192.168.1.177",56838,"185.136.68.153",443,22,6385,481,0,0,9,1575,13,4810,2770.464956,3.084389000000101,4085,12475
"192.168.1.62",51666,"192.168.1.177",7680,8,531,482,0,0,5,357,3,174,2774.599413,0.011269000000083906,253438,123524
"192.168.1.177",56841,"149.154.167.99",443,240,777119,483,0,0,59,8239,181,768880,2793.073804,42.17743900000005,1562,145837
"192.168.1.177",56843,"149.154.167.99",443,101,221946,484,0,0,27,3717,74,218229,2804.403478,30.959638999999697,960,56390
"192.168.1.177",56844,"149.154.170.200",443,106,378706,485,0,0,41,5176,65,373530,2804.414313,32.43761199999972,1276,92122
"192.168.1.177",56846,"34.120.208.123",443,37,6509,486,0,0,19,4021,18,2488,2813.475172,171.20657299999993,187,116
"192.168.1.62",51687,"192.168.1.177",7680,8,531,487,0,0,5,357,3,174,2814.614936,0.0072789999999258725,392361,191235
"192.168.1.177",56849,"68.232.34.52",443,19,8619,488,0,0,9,1371,10,7248,2837.434907,0.055565000000115106,197390,1043534
"192.168.1.177",56850,"185.136.68.153",443,22,6585,489,0,0,9,1775,13,4810,2838.668984,3.0789350000000013,4611,12497
"192.168.1.177",56851,"20.190.177.23",443,24,30089,490,0,0,14,8268,10,21821,2843.676102,0.331789000000299,199355,526141
"192.168.1.62",51720,"192.168.1.177",7680,8,531,491,0,0,5,357,3,174,2854.627148,0.008292999999866879,344386,167852
"192.168.1.62",51727,"192.168.1.177",7680,8,531,492,0,0,5,357,3,174,2894.637921,0.007197999999789317,396776,193387
"192.168.1.177",56857,"185.136.68.153",443,22,6579,493,0,0,9,1769,13,4810,2901.175926,3.0764090000002398,4600,12508
"192.168.1.177",56859,"192.229.221.95",80,10,1134,494,0,0,6,620,4,514,2903.848587,60.03567199999998,82,68
"192.168.1.62",51736,"192.168.1.177",7680,8,531,495,0,0,5,357,3,174,2934.641388,0.007091999999829568,402707,196277
"192.168.1.177",56863,"34.117.237.239",443,33,4707,496,0,0,17,2758,16,1949,2937.383894,170.8268039999998,129,91
"192.168.1.62",51747,"192.168.1.177",7680,8,531,497,0,0,5,357,3,174,2974.653375,0.005720999999994092,499213,243314
"192.168.1.177",56869,"52.184.217.20",443,21,5511,498,0,0,11,1919,10,3592,2991.966738,125.48979800000006,122,228
"192.168.1.62",51750,"192.168.1.177",7680,8,531,499,0,0,5,357,3,174,3014.671806,0.020828000000165048,137123,66833
"192.168.1.177",56874,"149.154.167.99",443,36,9999,500,0,0,19,2410,17,7589,3033.930194,170.70722100000012,112,355
"2001:14ba:a051:8c00:61b5:31a4:d1f8:cc83",56875,"2600:1901:1:c36::",443,1,86,501,0,0,1,86,0,0,3035.146885,0,"",""
"2001:14ba:a051:8c00:61b5:31a4:d1f8:cc83",56876,"2600:1901:1:c36::",443,1,86,502,0,0,1,86,0,0,3035.402712,0,"",""
"192.168.1.177",56877,"35.186.224.25",443,53,6573,503,0,0,26,3054,27,3519,3035.449638,610.1036909999998,40,46
"192.168.1.177",56878,"35.186.224.25",443,42,3997,504,0,0,21,1800,21,2197,3035.716545,660.0377859999999,21,26
"192.168.1.62",51767,"192.168.1.177",7680,8,531,505,0,0,5,357,3,174,3054.68032,0.006991000000198255,408525,199113
"192.168.1.177",50154,"195.148.124.36",80,10,1226,506,0,0,6,504,4,722,3068.573589,0.00825699999995777,488312,699527
"192.168.1.177",50156,"188.166.241.168",80,10,1228,507,0,0,6,505,4,723,3075.20088,0.8264349999999467,4888,6998
"192.168.1.177",56885,"20.189.173.18",443,31,8788,508,0,0,14,2881,17,5907,3090.794278,2.741537000000335,8406,17237
"192.168.1.62",51781,"192.168.1.177",7680,8,531,509,0,0,5,357,3,174,3094.683765,0.011341999999785912,251807,122729
"2001:14ba:a051:8c00:61b5:31a4:d1f8:cc83",56888,"2a02:26f0:41::216:1f93",443,5,430,510,0,0,5,430,0,0,3120.256497,15.047534000000269,228,0
"192.168.1.62",51785,"192.168.1.177",7680,8,531,511,0,0,5,357,3,174,3134.696654,0.00874599999997372,326549,159158
"2001:14ba:a051:8c00:61b5:31a4:d1f8:cc83",56892,"2a02:26f0:41::216:1f9b",443,5,430,512,0,0,5,430,0,0,3141.308081,15.015294999999696,229,0
"2001:14ba:a051:8c00:61b5:31a4:d1f8:cc83",56893,"2a00:1450:4026:804::200a",443,1,86,513,0,0,1,86,0,0,3141.977874,0,"",""
"2001:14ba:a051:8c00:61b5:31a4:d1f8:cc83",56894,"2a00:1450:4026:804::200a",443,1,86,514,0,0,1,86,0,0,3142.233073,0,"",""
"192.168.1.177",56895,"216.58.210.138",443,37,6706,515,0,0,18,2450,19,4256,3142.280046,240.0583670000001,81,141
"2001:14ba:a051:8c00:61b5:31a4:d1f8:cc83",56896,"2a00:1450:4026:804::200a",443,1,86,516,0,0,1,86,0,0,3142.3536,0,"",""
"192.168.1.177",56897,"216.58.210.138",443,26,3813,517,0,0,13,1567,13,2246,3142.543708,290.04098999999997,43,61
"2001:14ba:a051:8c00:61b5:31a4:d1f8:cc83",56898,"2a00:1450:4026:804::200a",443,1,86,518,0,0,1,86,0,0,3142.59066,0,"",""
"192.168.1.177",56899,"216.58.211.234",443,37,5893,519,0,0,18,2620,19,3273,3142.666795,240.30394399999977,87,108
"192.168.1.177",56900,"216.58.211.234",443,26,3878,520,0,0,13,1593,13,2285,3142.899229,290.030667,43,63
"192.168.1.177",56903,"104.84.152.10",443,29,32835,521,0,0,13,1277,16,31558,3162.333429,0.06380699999999706,160107,3956681
"192.168.1.177",56904,"185.136.68.153",443,22,6449,522,0,0,9,1639,13,4810,3163.465766,3.0786990000001424,4258,12498
"2001:14ba:a051:8c00:61b5:31a4:d1f8:cc83",56906,"2620:1ec:12::239",443,1,86,523,0,0,1,86,0,0,3172.102475,0,"",""
"2001:14ba:a051:8c00:61b5:31a4:d1f8:cc83",56908,"2620:1ec:12::239",443,1,86,524,0,0,1,86,0,0,3172.341609,0,"",""
"192.168.1.177",56910,"204.79.197.239",443,30,10098,525,0,0,13,2208,17,7890,3172.404978,125.45313900000019,140,503
"192.168.1.177",56911,"204.79.197.239",443,20,8236,526,0,0,9,1250,11,6986,3172.65432,123.72244599999976,80,451
"192.168.1.177",56912,"35.186.227.140",443,95,25439,527,0,0,43,18465,52,6974,3173.562636,172.15394399999968,858,324
"192.168.1.177",56913,"34.110.207.168",443,31,5672,528,0,0,17,3578,14,2094,3173.56734,170.92094499999985,167,98
"192.168.1.62",51794,"192.168.1.177",7680,8,531,529,0,0,5,357,3,174,3174.712805,0.005807999999888125,491735,239669
"2001:14ba:a051:8c00:61b5:31a4:d1f8:cc83",56914,"2620:1ec:12::239",443,1,86,530,0,0,1,86,0,0,3176.024246,0,"",""
"2001:14ba:a051:8c00:61b5:31a4:d1f8:cc83",56915,"2620:1ec:12::239",443,1,86,531,0,0,1,86,0,0,3176.284692,0,"",""
"192.168.1.177",56916,"204.79.197.239",443,34,17258,532,0,0,17,6226,17,11032,3176.330633,126.31949200000008,394,698
"2001:14ba:a051:8c00:61b5:31a4:d1f8:cc83",56917,"2a02:26f0:5200::17c9:2b89",443,1,86,533,0,0,1,86,0,0,3176.50938,0,"",""
"192.168.1.177",56918,"204.79.197.239",443,21,8290,534,0,0,8,1196,13,7094,3176.598442,127.4779010000002,75,445
"2001:14ba:a051:8c00:61b5:31a4:d1f8:cc83",56919,"2a02:26f0:5200::17c9:2b89",443,1,86,535,0,0,1,86,0,0,3176.757455,0,"",""
"192.168.1.177",56920,"95.101.142.225",443,32,6834,536,0,0,14,3724,18,3110,3176.820357,120.25543500000003,247,206
"192.168.1.177",56922,"95.101.142.225",443,18,2273,537,0,0,8,1123,10,1150,3177.071537,100.05918800000018,89,91
"192.168.1.177",56925,"72.25.64.8",443,68,64569,538,0,0,35,33325,33,31244,3200.906969,1.4900099999999838,178924,167751
"192.168.1.177",56926,"185.136.68.153",443,22,6425,539,0,0,9,1615,13,4810,3203.25683,3.0804840000000695,4194,12491
"192.168.1.62",51806,"192.168.1.177",7680,8,531,540,0,0,5,357,3,174,3214.715006,0.013521000000309868,211226,102950
"192.168.1.62",51809,"192.168.1.177",7680,8,531,541,0,0,5,357,3,174,3254.72064,0.011660000000119908,244939,119382
"192.168.1.62",51819,"192.168.1.177",7680,8,531,542,0,0,5,357,3,174,3294.752286,0.00853400000005422,334661,163112
"192.168.1.177",56939,"149.154.167.99",443,40,10890,543,0,0,21,3176,19,7714,3333.367647,176.24389900000006,144,350
"192.168.1.62",51830,"192.168.1.177",7680,8,531,544,0,0,5,357,3,174,3334.741334,0.007364000000052329,387832,189027
"192.168.1.177",56941,"149.154.167.99",443,49,28747,545,0,0,18,3571,31,25176,3343.473411,30.37582999999995,940,6630
"2001:14ba:a051:8c00:61b5:31a4:d1f8:cc83",56942,"2a05:d014:58f:6200::64",80,5,430,546,0,0,5,430,0,0,3351.426814,15.041356000000178,228,0
"2001:14ba:a051:8c00:61b5:31a4:d1f8:cc83",56945,"2a05:d014:275:cb01::c8",80,5,430,547,0,0,5,430,0,0,3372.469259,15.028953000000001,228,0
"192.168.1.62",51834,"192.168.1.177",7680,8,531,548,0,0,5,357,3,174,3374.747629,0.024346000000150525,117308,57175
"192.168.1.177",56948,"3.72.140.173",80,15,1268,549,0,0,8,553,7,715,3393.501986,67.95086599999968,65,84
"192.168.1.177",56949,"3.72.140.173",443,22,2365,550,0,0,12,1230,10,1135,3393.570536,67.88231599999972,144,133
"192.168.1.62",51847,"192.168.1.177",7680,8,531,551,0,0,5,357,3,174,3414.762734,0.006601000000046042,432661,210877
"2001:14ba:a051:8c00:61b5:31a4:d1f8:cc83",56956,"2a02:26f0:1200:58d::21cc",80,1,86,552,0,0,1,86,0,0,3453.664384,0,"",""
"192.168.1.177",56957,"23.60.21.15",80,10,1797,553,0,0,6,563,4,1234,3453.979221,61.13885200000004,73,161
"2001:14ba:a051:8c00:61b5:31a4:d1f8:cc83",56958,"2a02:26f0:1200:581::21cc",80,1,86,554,0,0,1,86,0,0,3454.052248,0,"",""
"192.168.1.177",56959,"23.60.21.15",80,10,1380,555,0,0,6,563,4,817,3454.364592,60.7725190000001,74,107
"2001:14ba:a051:8c00:61b5:31a4:d1f8:cc83",56960,"2a00:1450:4026:805::2003",80,1,86,556,0,0,1,86,0,0,3454.405096,0,"",""
"192.168.1.177",56961,"216.58.210.163",80,10,993,557,0,0,6,543,4,450,3454.706117,60.405297999999675,71,59
"2001:14ba:a051:8c00:61b5:31a4:d1f8:cc83",56962,"2001:1900:233b:1f00::1fe",80,1,86,558,0,0,1,86,0,0,3454.74107,0,"",""
"192.168.1.62",51871,"192.168.1.177",7680,8,531,559,0,0,5,357,3,174,3454.77905,0.01421200000004319,200956,97945
"192.168.1.177",56963,"93.184.221.240",80,12,1819,560,0,0,7,958,5,861,3455.049293,60.069668999999976,127,114
"2001:14ba:a051:8c00:61b5:31a4:d1f8:cc83",56965,"2a00:1450:4026:802::200a",443,1,86,561,0,0,1,86,0,0,3470.985615,0,"",""
"2001:14ba:a051:8c00:61b5:31a4:d1f8:cc83",56966,"2a00:1450:4026:802::200a",443,1,86,562,0,0,1,86,0,0,3471.238015,0,"",""
"192.168.1.177",56967,"216.58.210.138",443,1477,156984,563,0,0,592,56150,885,100834,3471.301216,2697.2099690000005,166,299
"192.168.1.177",56968,"216.58.210.138",443,16,3169,564,0,0,9,1373,7,1796,3471.549624,92.76705899999979,118,154
"192.168.1.62",51878,"192.168.1.177",7680,8,531,565,0,0,5,357,3,174,3494.793329,0.008313999999700172,343516,167428
"192.168.1.177",56974,"35.186.227.140",443,4930,2785514,566,0,0,2342,2536443,2588,249071,3527.640405,1876.3270830000001,10814,1061
"192.168.1.177",56975,"34.110.207.168",443,47,7640,567,0,0,24,4863,23,2777,3528.687921,302.0000579999996,128,73
"192.168.1.177",56977,"40.114.178.124",443,35,8607,568,0,0,16,2349,19,6258,3530.334561,20.113534000000072,934,2489
"192.168.1.62",51889,"192.168.1.177",7680,8,531,569,0,0,5,357,3,174,3534.797349,0.00800100000014936,356955,173978
"192.168.1.177",56978,"34.117.65.55",443,32,7955,570,0,0,15,1901,17,6054,3535.100945,170.43686099999968,89,284
"192.168.1.177",56979,"34.117.65.55",443,41,6022,571,0,0,17,3222,24,2800,3535.151179,2401.2315439999998,10,9
"192.168.1.177",56980,"34.149.100.209",443,88,84768,572,0,0,37,3846,51,80922,3535.584248,237.26527699999997,129,2728
"192.168.1.177",56981,"34.160.144.191",443,44,14093,573,0,0,19,2026,25,12067,3535.841075,170.9234980000001,94,564
"192.168.1.177",56982,"34.117.121.53",443,22,6558,574,0,0,11,1149,11,5409,3536.255838,0.07360000000016953,124891,587934
"192.168.1.177",56983,"34.117.121.53",443,47,13354,575,0,0,21,2276,26,11078,3536.256027,170.51638200000025,106,519
"192.168.1.177",56984,"62.183.170.50",80,32,3218,576,0,0,17,1375,15,1843,3536.315639,115.52479900000026,95,127
"192.168.1.177",56985,"62.183.170.50",80,32,3218,577,0,0,17,1375,15,1843,3536.315766,115.52563699999973,95,127
"192.168.1.177",56987,"216.58.211.234",443,29,10377,578,0,0,13,2915,16,7462,3549.295691,0.23138600000038423,100783,257993
"192.168.1.177",56988,"162.55.98.14",443,206,48911,579,0,0,97,22393,109,26518,3551.280851,402.95440599999984,444,526
"192.168.1.177",56990,"34.120.208.123",443,93,24556,580,0,0,45,15888,48,8668,3558.686109,323.2629469999997,393,214
"192.168.1.62",51912,"192.168.1.177",7680,8,531,581,0,0,5,357,3,174,3574.798143,0.007872000000133994,362804,176829
"192.168.1.177",56993,"149.154.167.99",443,86,34334,582,0,0,45,6345,41,27989,3578.223468,226.24856699999964,224,989
"192.168.1.177",56994,"149.154.167.99",443,827,3790945,583,0,0,226,25806,601,3765139,3578.536413,44.71877900000027,4616,673567
"192.168.1.177",56995,"149.154.170.200",443,211,948104,584,0,0,87,10722,124,937382,3579.472513,44.527104999999665,1926,168415
"192.168.1.177",56997,"149.154.174.200",443,51,173231,585,0,0,21,3293,30,169938,3586.745765,31.808808999999655,828,42739
"192.168.1.177",57000,"185.179.237.109",443,21,8615,586,0,0,11,1994,10,6621,3607.928299,5.0375639999997475,3166,10514
"192.168.1.177",57001,"185.179.237.109",443,38,9198,587,0,0,17,5156,21,4042,3614.428346,11.216750999999931,3677,2882
"192.168.1.62",51919,"192.168.1.177",7680,8,531,588,0,0,5,357,3,174,3614.801132,0.008391999999730615,340324,165872
"192.168.1.177",57003,"130.233.229.20",443,506,977112,589,0,0,312,379771,194,597341,3628.860928,18.92490399999997,160538,252510
"192.168.1.177",57005,"52.85.49.34",443,40,10201,590,0,0,19,2450,21,7751,3630.53638,170.88525299999992,114,362
"192.168.1.177",57006,"130.233.229.20",443,17,4419,591,0,0,9,3002,8,1417,3635.574175,4.042939999999817,5940,2803
"192.168.1.62",51930,"192.168.1.177",7680,8,531,592,0,0,5,357,3,174,3654.817576,0.00603000000000975,473631,230845
"192.168.1.177",50066,"195.148.124.36",80,10,1226,593,0,0,6,504,4,722,3668.668828,0.011358000000200263,354992,508540
"192.168.1.177",50110,"188.166.241.168",80,10,1228,594,0,0,6,505,4,723,3677.471962,0.8464770000000499,4772,6833
"192.168.1.177",57011,"95.216.67.183",443,32,8873,595,0,0,15,2179,17,6694,3682.362674,44.1557029999999,394,1212
"2001:14ba:a051:8c00:61b5:31a4:d1f8:cc83",57012,"2a01:4f8:271:134e::2",443,1,86,596,0,0,1,86,0,0,3682.385173,0,"",""
"192.168.1.177",57013,"162.55.98.14",443,42,9100,597,0,0,23,3234,19,5866,3682.636401,170.67841499999986,151,274
"192.168.1.177",57014,"62.183.170.50",80,32,3217,598,0,0,17,1375,15,1842,3682.748324,115.59051899999986,95,127
"192.168.1.62",51942,"192.168.1.177",7680,8,531,599,0,0,5,357,3,174,3694.819873,0.006063000000267493,471053,229589
"192.168.1.62",51947,"192.168.1.177",7680,8,531,600,0,0,5,357,3,174,3734.823269,0.011614000000008673,245910,119855
"192.168.1.62",51955,"192.168.1.177",7680,8,531,601,0,0,5,357,3,174,3774.838417,0.005407999999988533,528106,257396
"192.168.1.177",57026,"34.120.52.64",443,108,22769,602,0,0,48,6104,60,16665,3780.290333,346.4400450000003,140,384
"192.168.1.62",51999,"192.168.1.177",7680,8,531,603,0,0,5,357,3,174,3814.841083,0.007704000000103406,370716,180685
"192.168.1.177",57033,"34.117.237.239",443,32,4653,604,0,0,17,2758,15,1895,3840.219458,172.00079099999994,128,88
"192.168.1.62",52010,"192.168.1.177",7680,8,531,605,0,0,5,357,3,174,3854.846397,0.007655000000340806,373089,181841
"192.168.1.177",57036,"34.110.207.168",443,181,26752,606,0,0,91,18349,90,8403,3863.831649,1540.1429979999998,95,43
"192.168.1.177",57038,"149.154.167.99",443,45,37491,607,0,0,24,3538,21,33953,3877.059346,227.25444499999958,124,1195
"192.168.1.62",52018,"192.168.1.177",7680,8,531,608,0,0,5,357,3,174,3894.849338,0.007036999999854743,405854,197811
"192.168.1.177",57043,"34.117.138.150",443,33,8295,609,0,0,17,2016,16,6279,3915.698435,170.87244900000042,94,293
"192.168.1.62",52030,"192.168.1.177",7680,8,531,610,0,0,5,357,3,174,3934.867399,0.012054999999691063,236914,115470
"192.168.1.62",52095,"192.168.1.177",7680,8,531,611,0,0,5,357,3,174,3974.870307,0.006300999999893975,453261,220917
"192.168.1.62",52105,"192.168.1.177",7680,8,531,612,0,0,5,357,3,174,4014.881896,0.008125000000291038,351507,171323
"192.168.1.177",57054,"51.124.78.146",443,66,317721,613,0,0,27,3091,39,314630,4027.422834,0.4275470000002315,57836,5887165
"192.168.1.177",57055,"54.214.185.83",443,19,8432,614,0,0,10,2510,9,5922,4033.976225,1.0115500000001703,19850,46835
"192.168.1.177",57056,"192.229.221.95",80,32,3067,615,0,0,17,1376,15,1691,4034.423629,115.10369100000025,95,117
"192.168.1.177",57057,"34.120.158.37",443,36,70527,616,0,0,17,2229,19,68298,4034.834273,0.6055550000000949,29447,902286
"2001:14ba:a051:8c00:61b5:31a4:d1f8:cc83",57058,"2001:14b8:1800:300::3eb7:aa32",80,5,430,617,0,0,5,430,0,0,4034.897851,15.035865999999714,228,0
"192.168.1.177",57059,"62.183.170.50",80,32,3218,618,0,0,17,1375,15,1843,4035.198776,115.33147699999972,95,127
"192.168.1.177",57060,"34.120.158.37",443,25,16129,619,0,0,13,2529,12,13600,4035.272281,0.026018000000021857,777615,4181720
"192.168.1.177",57061,"34.120.158.37",443,25,6638,620,0,0,13,2535,12,4103,4035.300994,0.01731599999993705,1171171,1895587
"192.168.1.177",57062,"34.120.158.37",443,26,11429,621,0,0,13,2530,13,8899,4035.319779,0.22246799999993527,90979,320010
"192.168.1.177",57063,"34.120.158.37",443,28,8578,622,0,0,14,2590,14,5988,4035.340123,0.2218990000001213,93375,215882
"192.168.1.177",57064,"34.120.158.37",443,25,13304,623,0,0,13,2532,12,10772,4035.361503,0.020763999999871885,975534,4150260
"192.168.1.177",57065,"34.120.158.37",443,26,19778,624,0,0,13,2528,13,17250,4035.385435,0.224713999999949,89998,614113
"192.168.1.177",57066,"34.120.158.37",443,226,1530007,625,0,0,64,5285,162,1524722,4035.405883,0.2911690000000817,145207,41892426
"192.168.1.177",57067,"34.120.158.37",443,141,438732,626,0,0,32,3557,109,435175,4035.484508,0.25058099999978367,113560,13893311
"192.168.1.177",57068,"34.120.158.37",443,27,6642,627,0,0,13,2527,14,4115,4035.527953,0.22948500000029526,88092,143451
"192.168.1.177",57069,"34.120.158.37",443,25,4802,628,0,0,13,2543,12,2259,4035.551276,0.22536499999978332,90271,80189
"192.168.1.177",57070,"34.120.158.37",443,24,4427,629,0,0,12,2489,12,1938,4035.569742,0.23138699999981327,86054,67004
"192.168.1.177",57071,"34.120.158.37",443,23,4467,630,0,0,13,2542,10,1925,4035.593604,0.01665099999991071,1221308,924869
"192.168.1.177",57074,"34.98.75.36",443,41,9096,631,0,0,20,2478,21,6618,4053.449195,175.39038600000003,113,301
"192.168.1.177",57075,"62.183.170.50",80,32,3218,632,0,0,17,1375,15,1843,4053.474854,115.07334300000002,95,128
"2001:14ba:a051:8c00:61b5:31a4:d1f8:cc83",57076,"2600:1901:0:92a9::",443,1,86,633,0,0,1,86,0,0,4053.729258,0,"",""
"192.168.1.177",57077,"34.160.144.191",443,41,9381,634,0,0,21,2857,20,6524,4053.986738,174.85322599999972,130,298
"192.168.1.62",52126,"192.168.1.177",7680,8,531,635,0,0,5,357,3,174,4054.885183,0.005998000000090542,476158,232077
"192.168.1.177",57078,"62.183.170.50",80,6,348,636,0,0,4,228,2,120,4055.936226,5.589987000000292,326,171
"192.168.1.177",57081,"149.154.167.99",443,33,15306,637,0,0,15,2774,18,12532,4076.111648,30.272374000000127,733,3311
"192.168.1.62",52136,"192.168.1.177",7680,8,531,638,0,0,5,357,3,174,4094.893978,0.012124999999741704,235546,114804
"192.168.1.177",57086,"162.55.83.113",443,244,51563,639,0,0,113,21662,131,29901,4121.534392,635.6458040000007,272,376
"192.168.1.62",52161,"192.168.1.177",7680,8,531,640,0,0,5,357,3,174,4134.900309,0.007814999999936845,365451,178119
"2001:14ba:a051:8c00:61b5:31a4:d1f8:cc83",57089,"2a05:d014:58f:6200::64",80,5,430,641,0,0,5,430,0,0,4142.667827,15.025171999999657,228,0
"192.168.1.177",57090,"149.154.167.99",443,38,10859,642,0,0,21,3199,17,7660,4144.79985,260.391337,98,235
"192.168.1.177",57091,"149.154.167.99",443,55,126507,643,0,0,27,4441,28,122066,4144.919891,30.752874000000702,1155,31754
"2001:14ba:a051:8c00:61b5:31a4:d1f8:cc83",57094,"2a05:d014:275:cb01::c8",80,5,430,644,0,0,5,430,0,0,4163.698953,15.033024999999725,228,0
"192.168.1.62",52189,"192.168.1.177",7680,8,531,645,0,0,5,357,3,174,4174.902229,0.005599000000074739,510091,248615
"192.168.1.177",57097,"3.72.140.173",80,15,1268,646,0,0,8,553,7,715,4184.747304,67.9612419999994,65,84
"192.168.1.177",57098,"3.72.140.173",443,22,2365,647,0,0,12,1230,10,1135,4184.801447,67.90709900000002,144,133
"192.168.1.177",57099,"149.154.167.99",443,47,74045,648,0,0,22,3383,25,70662,4188.17642,35.71662600000036,757,15827
"192.168.1.62",52229,"192.168.1.177",7680,8,531,649,0,0,5,357,3,174,4214.912285,0.009771999999429681,292263,142447
"2001:14ba:a051:8c00:61b5:31a4:d1f8:cc83",57104,"2600:1901:1:c36::",443,1,86,650,0,0,1,86,0,0,4235.154006,0,"",""
"2001:14ba:a051:8c00:61b5:31a4:d1f8:cc83",57106,"2600:1901:1:c36::",443,1,86,651,0,0,1,86,0,0,4235.404308,0,"",""
"192.168.1.177",57107,"35.186.224.25",443,489,53603,652,0,0,222,24742,267,28861,4235.466162,1919.7352520000004,103,120
"192.168.1.177",57108,"35.186.224.25",443,42,4002,653,0,0,21,1805,21,2197,4235.715145,660.0352320000002,21,26
"192.168.1.177",57109,"149.154.167.99",443,77,79141,654,0,0,21,3717,56,75424,4236.155939,30.374093999999786,978,19865
"192.168.1.62",52244,"192.168.1.177",7680,8,531,655,0,0,5,357,3,174,4254.914989,0.005967000000055123,478632,233283
"192.168.1.177",50154,"195.148.124.36",80,10,1226,656,0,0,6,504,4,722,4267.696821,0.0100189999993745,402435,576504
"192.168.1.177",50074,"188.166.241.168",80,10,1228,657,0,0,6,505,4,723,4274.437762,0.8343350000004648,4842,6932
"192.168.1.177",57114,"149.154.167.99",443,88,194042,658,0,0,38,5238,50,188804,4285.329094,32.31984400000056,1296,46733
"192.168.1.177",57115,"149.154.167.99",443,69,211325,659,0,0,32,4519,37,206806,4285.460218,30.451686999999765,1187,54330
"192.168.1.62",52258,"192.168.1.177",7680,8,531,660,0,0,5,357,3,174,4294.930982,0.008233000000473112,346896,169075
"2001:14ba:a051:8c00:61b5:31a4:d1f8:cc83",57119,"2600:1901:1:81::",443,1,86,661,0,0,1,86,0,0,4304.787625,0,"",""
"2001:14ba:a051:8c00:61b5:31a4:d1f8:cc83",57120,"2600:1901:1:81::",443,1,86,662,0,0,1,86,0,0,4305.040539,0,"",""
"192.168.1.177",57121,"35.186.224.17",443,48,5604,663,0,0,24,3064,24,2540,4305.10233,610.0867910000006,40,33
"192.168.1.177",57122,"35.186.224.17",443,28,3053,664,0,0,15,1477,13,1576,4305.353157,373.5292020000006,31,33
"192.168.1.177",57125,"34.120.52.64",443,778,1130619,665,0,0,229,19779,549,1110840,4328.365589,637.3150290000003,248,13943
"192.168.1.62",52268,"192.168.1.177",7680,8,531,666,0,0,5,357,3,174,4334.942456,0.008163999999851512,349828,170504
"192.168.1.62",52280,"192.168.1.177",7680,8,531,667,0,0,5,357,3,174,4374.958446,0.020019999999931315,142657,69530
"192.168.1.177",57135,"34.120.208.123",443,50,11501,668,0,0,23,4961,27,6540,4413.857733,170.84728199999972,232,306
"192.168.1.62",52295,"192.168.1.177",7680,8,531,669,0,0,5,357,3,174,4414.972602,0.00767100000030041,372311,181462
"192.168.1.177",57137,"62.165.155.56",443,27,8615,670,0,0,13,2143,14,6472,4431.613128,30.26806099999976,566,1710
"192.168.1.62",52306,"192.168.1.177",7680,8,531,671,0,0,5,357,3,174,4454.980737,0.005466000000524218,522502,254665
"192.168.1.62",52328,"192.168.1.177",7680,8,531,672,0,0,5,357,3,174,4494.989099,0.008325999999215128,343021,167187
"192.168.1.62",52344,"192.168.1.177",7680,8,531,673,0,0,5,357,3,174,4535.003827,0.006256000000576023,456521,222506
"192.168.1.177",57148,"149.154.167.99",443,37,10031,674,0,0,20,2464,17,7567,4535.837886,170.92485099999976,115,354
"192.168.1.62",52359,"192.168.1.177",7680,8,531,675,0,0,5,357,3,174,4575.008077,0.010097999999743479,282828,137849
"192.168.1.177",57153,"20.54.232.160",443,26,18561,676,0,0,14,7576,12,10985,4577.349075,126.10964299999978,480,696
"192.168.1.177",57154,"149.154.167.99",443,125,133624,677,0,0,78,82474,47,51150,4587.888553,36.24534800000038,18203,11289
"192.168.1.177",57157,"216.58.209.174",443,77,17306,678,0,0,37,5826,40,11480,4609.766979,360.15990899999997,129,254
"192.168.1.177",57159,"130.233.229.20",443,102,247713,679,0,0,38,5466,64,242247,4612.703842,6.650104000000283,6575,291420
"192.168.1.177",57160,"52.85.49.34",443,37,10038,680,0,0,19,2450,18,7588,4614.387824,170.1994420000001,115,356
"192.168.1.62",52368,"192.168.1.177",7680,8,531,681,0,0,5,357,3,174,4615.014115,0.009317000000010012,306536,149404
"192.168.1.177",57161,"130.233.229.20",443,17,4420,682,0,0,9,3003,8,1417,4615.308321,4.053803999999218,5926,2796
"192.168.1.177",57163,"130.233.229.20",443,338,553455,683,0,0,261,370562,77,182893,4622.923408,9.932678000000124,298458,147306
"192.168.1.62",52396,"192.168.1.177",7680,8,531,684,0,0,5,357,3,174,4655.030092,0.010099000000082015,282800,137835
"2001:14ba:a051:8c00:61b5:31a4:d1f8:cc83",57169,"2600:1901:1:c36::",443,1,86,685,0,0,1,86,0,0,4678.897053,0,"",""
"2001:14ba:a051:8c00:61b5:31a4:d1f8:cc83",57170,"2600:1901:1:c36::",443,1,86,686,0,0,1,86,0,0,4679.141562,0,"",""
"192.168.1.177",57171,"35.186.224.25",443,209,49918,687,0,0,102,36337,107,13581,4679.202811,1454.7987279999998,199,74
"192.168.1.177",57172,"35.186.224.25",443,42,4002,688,0,0,21,1805,21,2197,4679.451774,660.0331049999995,21,26
"192.168.1.177",57173,"34.120.208.123",443,36,6714,689,0,0,19,4029,17,2685,4683.172729,171.3420210000004,188,125
"192.168.1.177",57175,"130.233.229.20",443,85,273247,690,0,0,36,5815,49,267432,4687.941517,1.9123920000001817,24325,1118732
"192.168.1.177",57176,"149.154.167.99",443,49,25221,691,0,0,18,3571,31,21650,4688.295374,30.48617000000013,937,5681
"192.168.1.177",57177,"130.233.229.20",443,24,9174,692,0,0,11,4336,13,4838,4690.389305,0.16622600000027887,208679,232839
"192.168.1.177",57178,"130.233.229.20",443,19,4527,693,0,0,9,3002,10,1525,4690.413968,4.064280999999937,5909,3001
"192.168.1.62",52420,"192.168.1.177",7680,8,531,694,0,0,5,357,3,174,4695.041179,0.005858000000444008,487538,237623
"192.168.1.177",57181,"130.233.229.20",443,380,902864,695,0,0,277,371228,103,531636,4710.336917,10.670561000000816,278319,398581
"192.168.1.62",52542,"192.168.1.177",7680,8,531,696,0,0,5,357,3,174,4735.052211,0.008705999999619962,328049,159889
"192.168.1.177",57186,"34.149.100.209",443,42,9072,697,0,0,20,2109,22,6963,4736.924642,170.89124400000037,98,325
"192.168.1.177",57187,"34.117.237.239",443,32,4653,698,0,0,17,2758,15,1895,4739.918743,170.91421600000012,129,88
"192.168.1.177",57192,"149.154.167.99",443,42,11609,699,0,0,22,3472,20,8137,4774.317951,231.17352800000026,120,281
"192.168.1.177",57193,"149.154.167.99",443,42,35409,700,0,0,20,3679,22,31730,4774.442995,30.397783999999774,968,8350
"192.168.1.177",57197,"130.233.229.20",443,64,262321,701,0,0,20,4735,44,257586,4802.168719,1.9412339999998949,19513,1061535
"192.168.1.177",57198,"130.233.229.20",443,24,9177,702,0,0,11,4337,13,4840,4804.737814,0.11884600000030332,291940,325799
"192.168.1.177",57199,"130.233.229.20",443,17,4419,703,0,0,9,3002,8,1417,4804.770018,4.050841999999648,5928,2798
"192.168.1.177",57202,"130.233.229.20",443,334,550363,704,0,0,259,367947,75,182416,4811.613619,8.098542000000634,363469,180196
"192.168.1.177",57203,"149.154.167.99",443,85,114055,705,0,0,24,3895,61,110160,4817.255133,30.447121000000152,1023,28944
"192.168.1.177",57204,"149.154.167.99",443,82,178633,706,0,0,26,4195,56,174438,4818.290421,30.40194700000029,1103,45901
"192.168.1.177",57206,"130.233.229.20",443,17,4390,707,0,0,9,2973,8,1417,4827.769141,4.049740999999813,5872,2799
"2001:14ba:a051:8c00:61b5:31a4:d1f8:cc83",57208,"2a00:1450:4026:805::200e",443,1,86,708,0,0,1,86,0,0,4840.613803,0,"",""
"192.168.1.177",57209,"216.58.210.174",443,1119,772988,709,0,0,411,198204,708,574784,4840.865954,553.0100680000005,2867,8314
"192.168.1.177",57210,"216.58.211.227",80,53,9902,710,0,0,29,4217,24,5685,4840.931197,158.432366,212,287
"2001:14ba:a051:8c00:61b5:31a4:d1f8:cc83",57211,"2a00:1450:4026:802::2003",443,1,86,711,0,0,1,86,0,0,4841.122349,0,"",""
"2001:14ba:a051:8c00:61b5:31a4:d1f8:cc83",57212,"2a00:1450:4026:804::2001",443,1,86,712,0,0,1,86,0,0,4841.122714,0,"",""
"2001:14ba:a051:8c00:61b5:31a4:d1f8:cc83",57213,"2a00:1450:4026:805::2003",443,1,86,713,0,0,1,86,0,0,4841.131921,0,"",""
"2001:14ba:a051:8c00:61b5:31a4:d1f8:cc83",57214,"2a00:1450:4026:808::2003",443,1,86,714,0,0,1,86,0,0,4841.162361,0,"",""
"2001:14ba:a051:8c00:61b5:31a4:d1f8:cc83",57215,"2a00:1450:4026:808::2003",443,1,86,715,0,0,1,86,0,0,4841.162573,0,"",""
"2001:14ba:a051:8c00:61b5:31a4:d1f8:cc83",57216,"2a00:1450:4026:802::2003",443,1,86,716,0,0,1,86,0,0,4841.221029,0,"",""
"2001:14ba:a051:8c00:61b5:31a4:d1f8:cc83",57217,"2a00:1450:4026:802::2003",443,1,86,717,0,0,1,86,0,0,4841.222145,0,"",""
"192.168.1.177",57218,"216.58.209.163",443,461,797715,718,0,0,149,40210,312,757505,4841.374357,242.72443500000008,1325,24966
"192.168.1.177",57219,"216.58.210.129",443,47,32840,719,0,0,21,2784,26,30056,4841.37495,176.3721149999992,126,1363
"192.168.1.177",57220,"216.58.211.227",443,83,27305,720,0,0,35,4058,48,23247,4841.424128,174.27079099999992,186,1067
"192.168.1.177",57221,"216.58.211.227",443,38,9923,721,0,0,18,2420,20,7503,4841.424433,170.13543500000014,113,352
"192.168.1.177",57222,"216.58.211.227",443,71,59280,722,0,0,25,3157,46,56123,4841.424665,171.14159300000028,147,2623
"192.168.1.177",57223,"216.58.211.227",80,8,456,723,0,0,4,228,4,228,4841.449893,5.619518000000426,324,324
"2001:14ba:a051:8c00:61b5:31a4:d1f8:cc83",57225,"2a00:1450:4026:805::200e",443,5,430,724,0,0,5,430,0,0,4846.680437,15.04154600000038,228,0
"192.168.1.177",57226,"216.58.210.174",443,21,9515,725,0,0,10,1489,11,8026,4846.934047,0.23779600000034407,50093,270012
"2001:14ba:a051:8c00:61b5:31a4:d1f8:cc83",57227,"2a00:1450:4026:808::200d",443,1,86,726,0,0,1,86,0,0,4847.070057,0,"",""
"192.168.1.177",57228,"216.58.211.237",443,62,19870,727,0,0,28,9052,34,10818,4847.32256,171.66282800000045,421,504
"192.168.1.177",57229,"162.55.83.113",443,150,33069,728,0,0,75,13869,75,19200,4847.905006,285.13687800000025,389,538
"192.168.1.177",57232,"216.58.210.174",443,21,3574,729,0,0,11,2161,10,1413,4867.730504,0.02319100000022445,745461,487430
"192.168.1.177",50102,"195.148.124.36",80,10,1226,730,0,0,6,504,4,722,4869.512888,0.008925000000090222,451764,647170
"192.168.1.177",50086,"188.166.241.168",80,10,1228,731,0,0,6,505,4,723,4876.246455,0.8277409999991505,4880,6987
"2001:14ba:a051:8c00:61b5:31a4:d1f8:cc83",57234,"2a00:1450:4026:808::200a",443,1,86,732,0,0,1,86,0,0,4883.512601,0,"",""
"192.168.1.177",57235,"216.58.210.138",443,51,19588,733,0,0,25,5322,26,14266,4883.764102,171.41029100000014,248,665
"2001:14ba:a051:8c00:61b5:31a4:d1f8:cc83",57236,"2a00:1450:4026:808::200e",443,1,86,734,0,0,1,86,0,0,4883.82182,0,"",""
"192.168.1.177",57237,"149.154.167.99",443,37,24557,735,0,0,17,3517,20,21040,4883.920819,30.384503000000223,925,5539
"192.168.1.177",57238,"216.58.211.238",443,40,10384,736,0,0,21,3982,19,6402,4884.074933,170.31629200000043,187,300
"192.168.1.177",57240,"20.189.173.1",443,27,8571,737,0,0,14,2880,13,5691,4890.849788,0.988006999999925,23319,46080
"2001:14ba:a051:8c00:61b5:31a4:d1f8:cc83",57246,"2a05:d014:275:cb02::c8",80,5,430,738,0,0,5,430,0,0,4935.14529,15.031348999999864,228,0
"2001:14ba:a051:8c00:61b5:31a4:d1f8:cc83",57249,"2a05:d014:275:cb00::c8",80,5,430,739,0,0,5,430,0,0,4956.181729,15.030197000000044,228,0
"192.168.1.177",57252,"18.192.231.252",80,15,1268,740,0,0,8,553,7,715,4977.22558,66.72227599999951,66,85
"192.168.1.177",57253,"18.192.231.252",443,26,6538,741,0,0,13,1326,13,5212,4977.284539,66.66331699999955,159,625
"192.168.1.177",57254,"185.179.237.109",443,47,15410,742,0,0,20,5465,27,9945,4981.027711,15.055906999999934,2903,5284
"192.168.1.177",57257,"185.179.237.109",443,34,11437,743,0,0,16,6062,18,5375,5002.463068,7.531657999999879,6438,5709
"192.168.1.177",57258,"216.58.210.138",443,51,19258,744,0,0,24,3216,27,16042,5003.81415,175.32434899999953,146,731
"192.168.1.177",57260,"34.120.208.123",443,77,14119,745,0,0,35,8949,42,5170,5017.779239,248.695874,287,166
"192.168.1.177",57267,"130.233.229.20",443,86,210932,746,0,0,32,5425,54,205507,5073.207286,1.4322110000002795,30302,1147914
"192.168.1.177",57268,"130.233.229.20",443,31,56743,747,0,0,13,4543,18,52200,5075.982256,1.7757069999997839,20467,235173
"192.168.1.177",57269,"130.233.229.20",443,96,300916,748,0,0,26,7409,70,293507,5079.303012,6.441406999999344,9201,364525
"192.168.1.177",57270,"130.233.229.20",443,20,4526,749,0,0,10,3001,10,1525,5081.353564,4.333306999999877,5540,2815
"192.168.1.177",57271,"216.58.209.202",443,29,8980,750,0,0,14,2253,15,6727,5081.614819,0.23930899999959365,75316,224880
"192.168.1.177",57272,"130.233.229.20",443,20,4541,751,0,0,10,3099,10,1442,5081.672721,4.099893999999949,6046,2813
"192.168.1.177",57273,"130.233.229.20",443,22,7904,752,0,0,11,2523,11,5381,5081.673676,4.134349999999358,4882,10412
"192.168.1.177",57274,"130.233.229.20",443,23,7933,753,0,0,11,2497,12,5436,5081.674168,4.1605560000007245,4801,10452
"192.168.1.177",57275,"130.233.229.20",443,17,6185,754,0,0,9,1268,8,4917,5081.674753,5.685947999999371,1784,6918
"192.168.1.177",57276,"40.114.177.156",443,5,330,755,0,0,1,66,4,264,5081.696109,7.2609459999994215,72,290
"192.168.1.177",57277,"40.114.177.156",443,37,9936,756,0,0,16,2111,21,7825,5081.76572,20.179009999999835,836,3102
"2001:14ba:a051:8c00:61b5:31a4:d1f8:cc83",57278,"2a00:1450:4026:803::2005",443,1,86,757,0,0,1,86,0,0,5081.99071,0,"",""
"192.168.1.177",57279,"216.58.209.197",443,38,9144,758,0,0,20,2543,18,6601,5082.276244,170.89118600000074,119,309
"192.168.1.177",57280,"216.58.211.227",80,38,5637,759,0,0,21,2470,17,3167,5082.320212,117.48281100000077,168,215
"192.168.1.177",57281,"216.58.211.227",443,7,462,760,0,0,1,66,6,396,5082.791961,30.99627000000055,17,102
"2001:14ba:a051:8c00:61b5:31a4:d1f8:cc83",57282,"2a00:1450:4026:808::2005",443,1,86,761,0,0,1,86,0,0,5082.934819,0,"",""
"2001:14ba:a051:8c00:61b5:31a4:d1f8:cc83",57283,"2a00:1450:4026:808::2005",443,1,86,762,0,0,1,86,0,0,5082.939815,0,"",""
"192.168.1.177",57284,"216.58.209.197",443,15,6724,763,0,0,9,1436,6,5288,5083.200562,0.050124000000323576,229191,843986
"192.168.1.177",57285,"216.58.209.197",443,3310,4582057,764,0,0,1057,406544,2253,4175513,5083.200731,320.7683910000005,10139,104137
"192.168.1.177",57286,"216.58.211.227",80,34,3143,765,0,0,17,1379,17,1764,5083.235061,115.49242400000003,95,122
"192.168.1.177",57287,"216.58.211.227",443,7,462,766,0,0,1,66,6,396,5083.6645,31.25849300000027,16,101
"192.168.1.177",57288,"216.58.209.202",443,27,4984,767,0,0,13,2774,14,2210,5083.789419,0.043932999999924505,505132,402430
"192.168.1.177",57290,"216.58.210.129",443,109,293816,768,0,0,39,4880,70,288936,5084.017735,185.56746799999928,210,12456
"192.168.1.177",57291,"216.58.211.227",443,7,462,769,0,0,1,66,6,396,5084.082159,31.119856000000254,16,101
"2001:14ba:a051:8c00:61b5:31a4:d1f8:cc83",57292,"2a00:1450:4026:805::200e",443,5,430,770,0,0,5,430,0,0,5084.107932,15.037562999999864,228,0
"2001:14ba:a051:8c00:61b5:31a4:d1f8:cc83",57293,"2a00:1450:4026:802::2003",443,1,86,771,0,0,1,86,0,0,5084.172645,0,"",""
"2001:14ba:a051:8c00:61b5:31a4:d1f8:cc83",57294,"2a00:1450:4026:802::2003",443,1,86,772,0,0,1,86,0,0,5084.177256,0,"",""
"2001:14ba:a051:8c00:61b5:31a4:d1f8:cc83",57295,"2a00:1450:4026:802::2003",443,1,86,773,0,0,1,86,0,0,5084.186738,0,"",""
"192.168.1.177",57296,"216.58.211.227",443,7,462,774,0,0,1,66,6,396,5084.256718,30.94496700000036,17,102
"2001:14ba:a051:8c00:61b5:31a4:d1f8:cc83",57297,"2a00:1450:4026:804::2004",443,1,86,775,0,0,1,86,0,0,5084.359108,0,"",""
"192.168.1.177",57298,"216.58.210.174",443,19,9404,776,0,0,10,1488,9,7916,5084.40016,0.2308130000001256,51574,274369
"192.168.1.177",57299,"216.58.211.227",443,237,84972,777,0,0,99,10592,138,74380,5084.468862,319.50286400000005,265,1862
"192.168.1.177",57300,"216.58.211.228",443,98,52269,778,0,0,45,9066,53,43203,5084.616489,314.30342999999993,230,1099
"2001:14ba:a051:8c00:61b5:31a4:d1f8:cc83",57301,"2a00:1450:4026:805::200a",443,1,86,779,0,0,1,86,0,0,5087.211197,0,"",""
"192.168.1.177",57302,"216.58.211.234",443,98,112270,780,0,0,42,7990,56,104280,5087.468167,173.74032100000022,367,4801
"2001:14ba:a051:8c00:61b5:31a4:d1f8:cc83",57303,"2a00:1450:4026:805::200a",443,1,86,781,0,0,1,86,0,0,5087.611759,0,"",""
"192.168.1.177",57304,"216.58.211.234",443,52,19156,782,0,0,25,4739,27,14417,5087.87866,174.5663799999993,217,660
"192.168.1.177",57305,"216.58.211.237",443,44,10653,783,0,0,20,5929,24,4724,5088.466606,170.937594,277,221
"2001:14ba:a051:8c00:61b5:31a4:d1f8:cc83",57306,"2a00:1450:4026:808::2001",443,1,86,784,0,0,1,86,0,0,5088.997729,0,"",""
"2001:14ba:a051:8c00:61b5:31a4:d1f8:cc83",57307,"2a00:1450:4026:808::2001",443,1,86,785,0,0,1,86,0,0,5089.067455,0,"",""
"2001:14ba:a051:8c00:61b5:31a4:d1f8:cc83",57308,"2a00:1450:4026:808::2001",443,5,430,786,0,0,5,430,0,0,5089.070787,15.032047000000603,228,0
"2001:14ba:a051:8c00:61b5:31a4:d1f8:cc83",57309,"2a00:1450:4026:808::2001",443,5,430,787,0,0,5,430,0,0,5089.073955,15.028959000000214,228,0
"2001:14ba:a051:8c00:61b5:31a4:d1f8:cc83",57310,"2a00:1450:4026:803::2001",443,1,86,788,0,0,1,86,0,0,5089.081885,0,"",""
"2001:14ba:a051:8c00:61b5:31a4:d1f8:cc83",57311,"2a00:1450:4026:803::2001",443,1,86,789,0,0,1,86,0,0,5089.08393,0,"",""
"2001:14ba:a051:8c00:61b5:31a4:d1f8:cc83",57312,"2a00:1450:4026:808::2001",443,5,430,790,0,0,5,430,0,0,5089.093156,15.024811000000227,228,0
"2001:14ba:a051:8c00:61b5:31a4:d1f8:cc83",57313,"2a00:1450:4026:803::2001",443,1,86,791,0,0,1,86,0,0,5089.097458,0,"",""
"2001:14ba:a051:8c00:61b5:31a4:d1f8:cc83",57314,"2a00:1450:4026:803::2001",443,1,86,792,0,0,1,86,0,0,5089.099122,0,"",""
"2001:14ba:a051:8c00:61b5:31a4:d1f8:cc83",57315,"2a00:1450:4026:803::2001",443,1,86,793,0,0,1,86,0,0,5089.100198,0,"",""
"192.168.1.177",57316,"216.58.210.161",443,376,1216378,794,0,0,120,14702,256,1201676,5089.276807,304.5992150000002,386,31560
"192.168.1.177",57317,"216.58.210.129",443,18,11658,795,0,0,9,1446,9,10212,5089.355502,0.29152799999974377,39680,280233
"192.168.1.177",57318,"216.58.211.225",443,17,11604,796,0,0,9,1446,8,10158,5089.355687,0.11099800000010873,104218,732121
"192.168.1.177",57319,"216.58.211.225",443,19,11712,797,0,0,10,1500,9,10212,5089.355817,0.3180560000000696,37729,256860
"192.168.1.177",57320,"216.58.211.225",443,19,11712,798,0,0,10,1500,9,10212,5089.355965,0.3152120000004288,38069,259177
"192.168.1.177",57321,"216.58.211.225",443,17,11604,799,0,0,9,1446,8,10158,5089.356114,0.09200099999998201,125737,883294
"192.168.1.177",57322,"216.58.211.225",443,18,11659,800,0,0,9,1446,9,10213,5089.356241,0.3018449999999575,38324,270681
"192.168.1.177",57323,"216.58.211.225",443,18,11658,801,0,0,9,1446,9,10212,5089.356371,0.2952800000002753,39176,276672
"192.168.1.177",57324,"216.58.211.225",443,139,147075,802,0,0,62,7600,77,139475,5089.356498,304.82251799999995,199,3660
"2001:14ba:a051:8c00:61b5:31a4:d1f8:cc83",57325,"2a00:1450:4026:808::200a",443,1,86,803,0,0,1,86,0,0,5090.020286,0,"",""
"2001:14ba:a051:8c00:61b5:31a4:d1f8:cc83",57326,"2a00:1450:4026:804::200a",443,1,86,804,0,0,1,86,0,0,5090.17576,0,"",""
"2001:14ba:a051:8c00:61b5:31a4:d1f8:cc83",57327,"2a00:1450:4026:808::200a",443,5,430,805,0,0,5,430,0,0,5090.196867,15.036184000000503,228,0
"192.168.1.177",57328,"216.58.209.170",443,255,262555,806,0,0,102,16394,153,246161,5090.278681,333.766791,392,5900
"192.168.1.177",57329,"216.58.211.234",443,17,12358,807,0,0,10,1504,7,10854,5090.4499,0.0387590000000273,310431,2240305
"192.168.1.177",57330,"216.58.210.170",443,36,14617,808,0,0,19,2654,17,11963,5090.450305,170.75818299999992,124,560
"2001:14ba:a051:8c00:61b5:31a4:d1f8:cc83",57331,"2a00:1450:4026:808::200a",443,1,86,809,0,0,1,86,0,0,5090.485278,0,"",""
"2001:14ba:a051:8c00:61b5:31a4:d1f8:cc83",57332,"2a00:1450:4026:804::200a",443,1,86,810,0,0,1,86,0,0,5090.530052,0,"",""
"192.168.1.177",57333,"216.58.209.170",443,181,36444,811,0,0,84,15326,97,21118,5090.749854,338.3393610000003,362,499
"192.168.1.177",57334,"216.58.210.170",443,41,17226,812,0,0,21,4297,20,12929,5090.7944,170.6398390000004,201,606
"2001:14ba:a051:8c00:61b5:31a4:d1f8:cc83",57335,"2a00:1450:4026:808::200e",443,1,86,813,0,0,1,86,0,0,5091.023591,0,"",""
"192.168.1.177",57336,"216.58.211.238",443,106,49718,814,0,0,44,9783,62,39935,5091.292843,302.5831790000002,258,1055
"2001:14ba:a051:8c00:61b5:31a4:d1f8:cc83",57337,"2a00:1450:4026:803::200a",443,5,430,815,0,0,5,430,0,0,5091.548492,15.02792700000009,228,0
"192.168.1.177",57338,"216.58.211.234",443,21,7425,816,0,0,10,1495,11,5930,5091.808826,0.9710299999997005,12316,48855
"192.168.1.177",57339,"54.77.70.157",443,35,8450,817,0,0,18,2652,17,5798,5093.546183,171.0239959999999,124,271
"192.168.1.177",57340,"192.229.221.95",80,32,3323,818,0,0,17,1376,15,1947,5093.70838,115.20419899999979,95,135
"192.168.1.177",57341,"91.195.247.8",443,45,8413,819,0,0,22,2771,23,5642,5093.821155,117.10359700000026,189,385
"2001:14ba:a051:8c00:61b5:31a4:d1f8:cc83",57342,"2606:4700::6812:f65",80,5,430,820,0,0,5,430,0,0,5093.885819,15.021654000000126,229,0
"192.168.1.177",57343,"104.18.14.101",80,32,3296,821,0,0,17,1376,15,1920,5094.198797,115.72283299999981,95,132
"192.168.1.177",57344,"91.195.247.11",443,106,218693,822,0,0,31,7130,75,211563,5094.364273,21.07167699999991,2706,80321
"192.168.1.177",57345,"91.195.247.11",443,81,152395,823,0,0,26,4528,55,147867,5094.48149,20.955426999999872,1728,56450
"192.168.1.177",57346,"91.195.247.11",443,310,788930,824,0,0,82,11267,228,777663,5094.488822,55.646733999999924,1619,111799
"2001:14ba:a051:8c00:61b5:31a4:d1f8:cc83",57347,"2a02:26f0:41:386::1e80",443,1,86,825,0,0,1,86,0,0,5094.521743,0,"",""
"192.168.1.177",57348,"104.76.24.246",443,71,130641,826,0,0,26,2808,45,127833,5094.781333,120.07508700000017,187,8516
"192.168.1.177",57349,"91.195.247.11",443,19,5535,827,0,0,9,1322,10,4213,5094.78818,6.632109000000128,1594,5081
"192.168.1.177",57351,"91.195.246.80",443,48,9171,828,0,0,23,3390,25,5781,5095.466879,116.46801400000004,232,397
"2001:14ba:a051:8c00:61b5:31a4:d1f8:cc83",57352,"2a00:1450:4026:802::2003",443,1,86,829,0,0,1,86,0,0,5098.361134,0,"",""
"192.168.1.177",57353,"216.58.210.174",443,22,3627,830,0,0,11,2160,11,1467,5105.154015,0.23342200000024604,74029,50278
"192.168.1.177",57355,"216.58.210.129",443,20,3531,831,0,0,11,2172,9,1359,5110.105952,0.017835000000559376,974264,609587
"192.168.1.177",57356,"216.58.211.225",443,21,3585,832,0,0,11,2172,10,1413,5110.107114,0.020192999999380845,860496,559797
"192.168.1.177",57357,"216.58.211.225",443,22,3639,833,0,0,11,2172,11,1467,5110.122046,0.22390599999926053,77603,52414
"192.168.1.177",57358,"216.58.211.234",443,22,3643,834,0,0,11,2176,11,1467,5111.245157,0.22639799999979004,76891,51837
"192.168.1.177",57359,"216.58.211.234",443,21,3580,835,0,0,11,2167,10,1413,5112.586863,0.025165999999444466,688865,449177
"192.168.1.177",57360,"104.18.14.101",80,7,402,836,0,0,4,228,3,174,5114.908219,5.033973999999944,362,276
"192.168.1.177",57363,"149.154.167.99",443,39,10160,837,0,0,20,2463,19,7697,5135.962744,170.766482,115,360
"192.168.1.177",57366,"91.195.247.11",443,82,142878,838,0,0,28,3313,54,139565,5152.949483,21.56296199999997,1229,51779
"192.168.1.177",57369,"130.233.229.20",443,77,289142,839,0,0,26,6418,51,282724,5179.441924,6.216873000000305,8258,363815
"192.168.1.177",57375,"130.233.231.219",443,21,9505,840,0,0,10,1108,11,8397,5199.394844,0.15415399999983492,57500,435772
"192.168.1.177",57379,"149.154.167.99",443,49,71255,841,0,0,24,3895,25,67360,5204.669588,30.448436000000584,1023,17698
"192.168.1.177",57382,"91.195.247.11",443,31,9123,842,0,0,14,3462,17,5661,5215.037325,24.562439999999697,1127,1843
"2001:14ba:a051:8c00:ad01:ffd8:f040:eb85",57387,"2a00:1450:4026:803::2003",443,1,86,843,0,0,1,86,0,0,5232.293528,0,"",""
"2001:14ba:a051:8c00:ad01:ffd8:f040:eb85",57388,"2a00:1450:4026:803::2003",443,1,86,844,0,0,1,86,0,0,5232.323511,0,"",""
"2001:14ba:a051:8c00:ad01:ffd8:f040:eb85",57389,"2a00:1450:4026:808::200e",443,1,86,845,0,0,1,86,0,0,5232.580565,0,"",""
"2001:14ba:a051:8c00:ad01:ffd8:f040:eb85",57390,"2a00:1450:4026:805::200e",443,5,430,846,0,0,5,430,0,0,5232.651302,15.02027199999975,229,0
"2001:14ba:a051:8c00:ad01:ffd8:f040:eb85",57391,"2a00:1450:4026:803::2003",443,1,86,847,0,0,1,86,0,0,5232.80385,0,"",""
"192.168.1.177",57392,"216.58.211.238",443,61,14405,848,0,0,29,4241,32,10164,5232.83732,161.03870200000074,210,504
"192.168.1.177",57393,"216.58.210.174",443,17,9300,849,0,0,9,1437,8,7863,5232.915304,0.024217000000135158,474707,2597514
"2001:14ba:a051:8c00:ad01:ffd8:f040:eb85",57394,"2a00:1450:4026:808::200e",443,5,430,850,0,0,5,430,0,0,5232.986069,15.029820000000655,228,0
"192.168.1.177",57395,"216.58.211.238",443,19,9411,851,0,0,9,1440,10,7971,5233.243964,0.030077999999775784,383004,2120087
"2001:14ba:a051:8c00:ad01:ffd8:f040:eb85",57396,"2a00:1450:4026:808::200a",443,5,430,852,0,0,5,430,0,0,5233.367919,15.02134500000011,229,0
"192.168.1.177",57397,"216.58.209.202",443,19,7319,853,0,0,11,1551,8,5768,5233.629612,0.02734099999997852,453823,1687721
"192.168.1.177",57398,"34.149.100.209",443,41,4657,854,0,0,23,2699,18,1958,5237.556115,156.62362799999937,137,100
"192.168.1.177",57399,"18.165.122.26",443,54,19977,855,0,0,29,3080,25,16897,5237.557779,170.81396700000005,144,791
"192.168.1.177",57400,"34.160.90.233",443,66,15011,856,0,0,31,4187,35,10824,5237.818642,156.0573800000002,214,554
"192.168.1.177",57401,"34.160.90.233",443,21,5690,857,0,0,10,1085,11,4605,5237.818803,0.0443409999998039,195755,830833
"192.168.1.177",57402,"34.160.90.233",443,21,5690,858,0,0,10,1085,11,4605,5237.81897,0.0441739999996571,196495,833974
"192.168.1.177",57403,"34.160.90.233",443,21,5690,859,0,0,10,1085,11,4605,5237.819133,0.04401099999995495,197223,837063
"192.168.1.177",57404,"34.160.90.233",443,20,5636,860,0,0,10,1085,10,4551,5237.819278,0.04386599999997998,197875,829982
"192.168.1.177",57405,"35.244.181.201",443,47,8196,861,0,0,24,2487,23,5709,5238.070421,155.80560100000002,127,293
"192.168.1.177",57408,"216.58.210.174",443,20,3522,862,0,0,11,2163,9,1359,5253.680154,0.01837599999998929,941663,591641
"192.168.1.177",57409,"216.58.211.238",443,21,3579,863,0,0,11,2166,10,1413,5254.020042,0.0152379999999539,1137157,741829
"2001:14ba:a051:8c00:ad01:ffd8:f040:eb85",57410,"2a00:1450:4026:802::200a",443,5,430,864,0,0,5,430,0,0,5254.394993,15.017861999999695,229,0
"192.168.1.177",57412,"34.160.178.214",443,35,10003,865,0,0,16,2631,19,7372,5266.99952,0.21002899999984947,100214,280799
"192.168.1.177",57413,"216.58.210.163",80,32,3061,866,0,0,17,1393,15,1668,5267.024394,115.16320199999973,96,115
"2001:14ba:a051:8c00:ad01:ffd8:f040:eb85",57414,"2600:9000:25f7:3800:18:4845:acc0:93a1",443,1,86,867,0,0,1,86,0,0,5267.46255,0,"",""
"192.168.1.177",57415,"18.165.140.127",443,374,541530,868,0,0,160,17348,214,524182,5267.714233,171.55009100000007,808,24444
"2001:14ba:a051:8c00:ad01:ffd8:f040:eb85",57416,"2606:4700:4400::6812:205a",443,1,86,869,0,0,1,86,0,0,5268.266945,0,"",""
"2001:14ba:a051:8c00:ad01:ffd8:f040:eb85",57417,"2600:9000:25f7:dc00:1d:8345:69c0:93a1",443,1,86,870,0,0,1,86,0,0,5268.268067,0,"",""
"2001:14ba:a051:8c00:ad01:ffd8:f040:eb85",57418,"2600:9000:25f7:dc00:1d:8345:69c0:93a1",443,1,86,871,0,0,1,86,0,0,5268.269189,0,"",""
"2001:14ba:a051:8c00:ad01:ffd8:f040:eb85",57419,"2600:9000:25f7:dc00:1d:8345:69c0:93a1",443,1,86,872,0,0,1,86,0,0,5268.271742,0,"",""
"2001:14ba:a051:8c00:ad01:ffd8:f040:eb85",57420,"2600:9000:25f7:dc00:1d:8345:69c0:93a1",443,1,86,873,0,0,1,86,0,0,5268.273808,0,"",""
"2001:14ba:a051:8c00:ad01:ffd8:f040:eb85",57421,"2600:9000:25f7:dc00:1d:8345:69c0:93a1",443,1,86,874,0,0,1,86,0,0,5268.519728,0,"",""
"2001:14ba:a051:8c00:ad01:ffd8:f040:eb85",57422,"2600:9000:25f7:dc00:1d:8345:69c0:93a1",443,1,86,875,0,0,1,86,0,0,5268.521363,0,"",""
"192.168.1.177",57423,"104.18.32.90",443,67,28051,876,0,0,40,3946,27,24105,5268.525456,170.74188499999946,184,1129
"192.168.1.177",57424,"18.165.140.68",443,20,8272,877,0,0,10,1496,10,6776,5268.525763,0.05015000000003056,238644,1080917
"192.168.1.177",57425,"18.165.140.68",443,19,8218,878,0,0,10,1496,9,6722,5268.525987,0.050376000000142085,237573,1067492
"192.168.1.177",57426,"18.165.140.68",443,20,8272,879,0,0,10,1496,10,6776,5268.526239,0.05199799999991228,230162,1042501
"192.168.1.177",57427,"18.165.140.68",443,89,222407,880,0,0,52,5222,37,217185,5268.526421,170.73794400000043,244,10176
"2001:14ba:a051:8c00:ad01:ffd8:f040:eb85",57428,"2a02:26f0:e2::6854:98e9",443,1,86,881,0,0,1,86,0,0,5268.706168,0,"",""
"192.168.1.177",57429,"2.21.240.165",443,83,104450,882,0,0,38,3614,45,100836,5268.97788,120.79789600000004,239,6677
"2001:14ba:a051:8c00:ad01:ffd8:f040:eb85",57430,"2a02:26f0:1200:2b4::f09",443,1,86,883,0,0,1,86,0,0,5269.090867,0,"",""
"192.168.1.177",57431,"23.61.233.27",443,44,9163,884,0,0,20,2593,24,6570,5269.360129,120.41825900000003,172,436
"192.168.1.177",57433,"20.54.232.160",443,28,15566,885,0,0,15,5930,13,9636,5275.036258,93.76406399999996,505,822
"2001:14ba:a051:8c00:ad01:ffd8:f040:eb85",57434,"2a02:26f0:5200::b81f:fa9",443,1,86,886,0,0,1,86,0,0,5275.229971,0,"",""
"2001:14ba:a051:8c00:ad01:ffd8:f040:eb85",57436,"2a02:26f0:5200::b81f:f89",443,1,86,887,0,0,1,86,0,0,5275.372969,0,"",""
"2001:14ba:a051:8c00:ad01:ffd8:f040:eb85",57435,"2a02:26f0:5200::b81f:f89",443,1,86,888,0,0,1,86,0,0,5275.372969,0,"",""
"192.168.1.177",57437,"216.58.209.202",443,22,3636,889,0,0,11,2169,11,1467,5275.421829,0.21715099999983067,79907,54045
"192.168.1.177",57438,"2.22.31.104",443,58,56506,890,0,0,29,6140,29,50366,5275.543629,2.5989410000001953,18900,155035
"2001:14ba:a051:8c00:ad01:ffd8:f040:eb85",57439,"2603:1026:c11:c55::2",443,1,86,891,0,0,1,86,0,0,5275.666,0,"",""
"192.168.1.177",57440,"2.22.31.104",443,38,13011,892,0,0,18,2036,20,10975,5275.683825,2.4557429999995293,6632,35752
"192.168.1.177",57441,"2.22.31.104",443,27,8234,893,0,0,13,1161,14,7073,5275.683825,2.4558829999996306,3781,23040
"192.168.1.177",57442,"20.190.177.83",443,23,30236,894,0,0,14,8301,9,21935,5275.803943,0.3695669999997335,179691,474825
"192.168.1.177",57443,"52.98.149.162",443,25,9313,895,0,0,13,2540,12,6773,5275.979717,2.190128999999615,9277,24740
"192.168.1.177",57444,"52.168.117.168",443,29,10478,896,0,0,17,3017,12,7461,5276.240331,2.002664999999979,12051,29804
"2001:14ba:a051:8c00:ad01:ffd8:f040:eb85",57445,"2a02:26f0:5200::b81f:fa9",443,1,86,897,0,0,1,86,0,0,5279.481257,0,"",""
"192.168.1.177",57446,"2.22.31.104",443,114,69037,898,0,0,64,58107,50,10930,5279.786079,126.82536599999912,3665,689
"192.168.1.177",57447,"20.105.95.163",443,17,11049,899,0,0,10,2649,7,8400,5281.443226,0.2354089999998905,90022,285460
"2001:14ba:a051:8c00:ad01:ffd8:f040:eb85",57450,"2620:1ec:46::53",443,1,86,900,0,0,1,86,0,0,5283.534892,0,"",""
"192.168.1.177",57451,"13.107.213.53",443,31,10670,901,0,0,15,1723,16,8947,5283.850472,75.33699400000023,182,950
"2001:14ba:a051:8c00:ad01:ffd8:f040:eb85",57452,"2603:1063:2000::254",443,1,86,902,0,0,1,86,0,0,5284.190581,0,"",""
"192.168.1.177",57453,"52.108.8.254",443,30,10380,903,0,0,12,1894,18,8486,5284.492582,125.20353700000032,121,542
"192.168.1.177",57454,"204.79.197.254",443,30,10374,904,0,0,13,1945,17,8429,5284.684163,127.96745900000042,121,526
"192.168.1.177",57455,"204.79.197.222",443,25,10023,905,0,0,11,2319,14,7704,5284.880239,122.12458499999957,151,504
"2001:14ba:a051:8c00:ad01:ffd8:f040:eb85",57459,"2a00:1450:4026:808::2003",443,1,86,906,0,0,1,86,0,0,5289.160699,0,"",""
"2001:14ba:a051:8c00:ad01:ffd8:f040:eb85",57460,"2a00:1450:4026:808::2003",443,1,86,907,0,0,1,86,0,0,5289.399008,0,"",""
"192.168.1.177",57461,"216.58.211.227",443,91,75544,908,0,0,34,12558,57,62986,5289.476351,69.5294159999994,1444,7247
"192.168.1.177",57462,"216.58.211.227",443,14,3038,909,0,0,8,1314,6,1724,5289.711585,64.10101599999962,163,215
"2001:14ba:a051:8c00:ad01:ffd8:f040:eb85",57468,"2a00:1450:4010:c02::bc",5228,1,86,910,0,0,1,86,0,0,5301.332243,0,"",""
"2001:14ba:a051:8c00:ad01:ffd8:f040:eb85",57469,"2a00:1450:4026:805::200a",443,1,86,911,0,0,1,86,0,0,5301.335714,0,"",""
"192.168.1.177",57470,"216.58.210.142",443,16,9420,912,0,0,9,1090,7,8330,5301.336092,52.490271000000575,166,1269
"192.168.1.177",57471,"216.58.210.142",443,16,9421,913,0,0,9,1090,7,8331,5301.336406,52.4899149999992,166,1269
"192.168.1.177",57472,"216.58.210.142",443,16,9421,914,0,0,9,1090,7,8331,5301.336725,52.48952899999949,166,1269
"192.168.1.177",57473,"216.58.210.142",443,19,9584,915,0,0,9,1090,10,8494,5301.337023,52.48931900000025,166,1294
"2001:14ba:a051:8c00:ad01:ffd8:f040:eb85",57474,"2a00:1450:4026:803::200a",443,1,86,916,0,0,1,86,0,0,5301.364651,0,"",""
"2001:14ba:a051:8c00:ad01:ffd8:f040:eb85",57475,"2a00:1450:4026:808::200e",443,1,86,917,0,0,1,86,0,0,5301.388131,0,"",""
"2001:14ba:a051:8c00:ad01:ffd8:f040:eb85",57476,"2a00:1450:4026:808::200d",443,1,86,918,0,0,1,86,0,0,5301.388324,0,"",""
"2001:14ba:a051:8c00:ad01:ffd8:f040:eb85",57477,"2a00:1450:4026:805::200e",443,1,86,919,0,0,1,86,0,0,5301.388601,0,"",""
"2001:14ba:a051:8c00:ad01:ffd8:f040:eb85",57478,"2a00:1450:4026:808::2005",443,1,86,920,0,0,1,86,0,0,5301.391399,0,"",""
"2001:14ba:a051:8c00:ad01:ffd8:f040:eb85",57479,"2a00:1450:4026:808::2003",443,1,86,921,0,0,1,86,0,0,5301.419487,0,"",""
"2001:14ba:a051:8c00:ad01:ffd8:f040:eb85",57480,"2600:9000:25f7:3800:18:4845:acc0:93a1",443,1,86,922,0,0,1,86,0,0,5301.424915,0,"",""
"2001:14ba:a051:8c00:ad01:ffd8:f040:eb85",57481,"2a00:1450:4026:808::2005",443,1,86,923,0,0,1,86,0,0,5301.560607,0,"",""
"2001:14ba:a051:8c00:ad01:ffd8:f040:eb85",57482,"2600:9000:25f7:3800:18:4845:acc0:93a1",443,1,86,924,0,0,1,86,0,0,5301.561399,0,"",""
"2001:14ba:a051:8c00:ad01:ffd8:f040:eb85",57483,"2a00:1450:4026:805::200a",443,1,86,925,0,0,1,86,0,0,5301.592237,0,"",""
"2001:14ba:a051:8c00:ad01:ffd8:f040:eb85",57484,"2a00:1450:4026:808::2005",443,1,86,926,0,0,1,86,0,0,5301.621228,0,"",""
"2001:14ba:a051:8c00:ad01:ffd8:f040:eb85",57485,"2a00:1450:4026:803::200a",443,1,86,927,0,0,1,86,0,0,5301.621872,0,"",""
"192.168.1.177",57486,"108.177.14.188",5228,31,9943,928,0,0,14,1532,17,8411,5301.636877,229.69848300000012,53,292
"192.168.1.177",57487,"216.58.211.234",443,66,17312,929,0,0,30,4677,36,12635,5301.637706,52.18975099999989,716,1936
"2001:14ba:a051:8c00:ad01:ffd8:f040:eb85",57488,"2a00:1450:4026:805::200a",443,1,86,930,0,0,1,86,0,0,5301.638349,0,"",""
"2001:14ba:a051:8c00:ad01:ffd8:f040:eb85",57489,"2a00:1450:4026:805::200a",443,1,86,931,0,0,1,86,0,0,5301.638921,0,"",""
"2001:14ba:a051:8c00:ad01:ffd8:f040:eb85",57490,"2a00:1450:4026:808::200e",443,1,86,932,0,0,1,86,0,0,5301.639433,0,"",""
"2001:14ba:a051:8c00:ad01:ffd8:f040:eb85",57491,"2a00:1450:4026:808::200d",443,1,86,933,0,0,1,86,0,0,5301.639895,0,"",""
"2001:14ba:a051:8c00:ad01:ffd8:f040:eb85",57492,"2a00:1450:4026:805::200e",443,1,86,934,0,0,1,86,0,0,5301.640376,0,"",""
"192.168.1.177",57493,"216.58.210.138",443,77,17242,935,0,0,34,4999,43,12243,5301.665117,52.162272000000485,766,1877
"2001:14ba:a051:8c00:ad01:ffd8:f040:eb85",57494,"2a00:1450:4026:803::200a",443,1,86,936,0,0,1,86,0,0,5301.66581,0,"",""
"2001:14ba:a051:8c00:ad01:ffd8:f040:eb85",57495,"2a00:1450:4026:808::2003",443,1,86,937,0,0,1,86,0,0,5301.67639,0,"",""
"192.168.1.177",57496,"216.58.211.238",443,34,14404,938,0,0,16,2965,18,11439,5301.688657,52.13857900000039,454,1755
"192.168.1.177",57497,"216.58.211.237",443,35,12922,939,0,0,17,4130,18,8792,5301.689109,52.13823700000012,633,1349
"192.168.1.177",57498,"216.58.210.174",443,23,8455,940,0,0,13,1892,10,6563,5301.689547,52.13797900000009,290,1007
"192.168.1.177",57499,"216.58.211.229",443,70,95098,941,0,0,29,5134,41,89964,5301.692946,52.134651000000304,787,13804
"192.168.1.177",57500,"216.58.209.163",443,66,21570,942,0,0,33,9931,33,11639,5301.719796,52.10768399999961,1524,1786
"192.168.1.177",57501,"18.165.140.127",443,347,575651,943,0,0,126,14379,221,561272,5301.728227,52.09905400000025,2207,86185
"2001:14ba:a051:8c00:ad01:ffd8:f040:eb85",57502,"2a00:1450:4026:808::200a",443,1,86,944,0,0,1,86,0,0,5301.745423,0,"",""
"2001:14ba:a051:8c00:ad01:ffd8:f040:eb85",57503,"2a00:1450:4010:c08::66",443,1,86,945,0,0,1,86,0,0,5301.787722,0,"",""
"192.168.1.177",57504,"18.165.140.127",443,16,1924,946,0,0,8,1026,8,898,5301.861809,51.96530799999982,157,138
"192.168.1.177",57505,"216.58.211.229",443,14,2968,947,0,0,8,1286,6,1682,5301.925426,51.9011500000006,198,259
"192.168.1.177",57506,"216.58.211.234",443,14,2983,948,0,0,8,1292,6,1691,5301.944175,51.88261600000078,199,260
"192.168.1.177",57507,"216.58.211.238",443,14,2988,949,0,0,8,1294,6,1694,5301.944354,51.882087999999385,199,261
"192.168.1.177",57508,"216.58.211.237",443,14,2988,950,0,0,8,1294,6,1694,5301.94449,51.881726999999955,199,261
"192.168.1.177",57509,"216.58.210.174",443,14,3013,951,0,0,8,1304,6,1709,5301.944612,51.882548999999926,201,263
"192.168.1.177",57510,"216.58.210.138",443,14,3068,952,0,0,8,1326,6,1742,5301.976149,51.85047200000008,204,268
"192.168.1.177",57511,"216.58.209.163",443,14,2998,953,0,0,8,1298,6,1700,5301.979213,51.847547000000304,200,262
"2001:14ba:a051:8c00:ad01:ffd8:f040:eb85",57512,"2a00:1450:4026:808::200a",443,1,86,954,0,0,1,86,0,0,5302.004278,0,"",""
"2001:14ba:a051:8c00:ad01:ffd8:f040:eb85",57513,"2a00:1450:4026:808::2001",443,1,86,955,0,0,1,86,0,0,5302.022292,0,"",""
"2001:14ba:a051:8c00:ad01:ffd8:f040:eb85",57514,"2a00:1450:4010:c08::66",443,1,86,956,0,0,1,86,0,0,5302.052211,0,"",""
"192.168.1.177",57515,"216.58.211.234",443,31,10213,957,0,0,15,2619,16,7594,5302.052518,51.774985000000015,404,1173
"192.168.1.177",57516,"64.233.165.101",443,29,11791,958,0,0,14,2127,15,9664,5302.099001,51.72888899999998,328,1494
"2001:14ba:a051:8c00:ad01:ffd8:f040:eb85",57517,"2a00:1450:4026:808::2001",443,1,86,959,0,0,1,86,0,0,5302.283862,0,"",""
"192.168.1.177",57518,"216.58.211.234",443,14,3078,960,0,0,8,1330,6,1748,5302.307511,51.518786999999975,206,271
"192.168.1.177",57520,"216.58.210.129",443,1907,7278505,961,0,0,912,72231,995,7206274,5302.32877,51.49864199999956,11220,1119450
"192.168.1.177",57522,"64.233.165.101",443,14,2983,962,0,0,8,1292,6,1691,5302.353852,51.47324000000026,200,262
"2001:14ba:a051:8c00:ad01:ffd8:f040:eb85",57523,"2a00:1450:4026:808::200e",443,1,86,963,0,0,1,86,0,0,5302.467171,0,"",""
"192.168.1.177",57524,"216.58.210.129",443,14,3043,964,0,0,8,1316,6,1727,5302.592762,51.23372500000005,205,269
"2001:14ba:a051:8c00:ad01:ffd8:f040:eb85",57525,"2a00:1450:4026:808::200e",443,1,86,965,0,0,1,86,0,0,5302.733718,0,"",""
"192.168.1.177",57526,"216.58.211.238",443,152,52193,966,0,0,61,21924,91,30269,5302.781107,51.046033000000534,3435,4743
"192.168.1.177",57527,"216.58.211.238",443,14,2988,967,0,0,8,1294,6,1694,5303.046154,50.78031100000044,203,266
"192.168.1.177",57529,"108.156.22.66",443,43,48003,968,0,0,19,2510,24,45493,5305.096063,48.73180599999978,412,7468
"2001:14ba:a051:8c00:ad01:ffd8:f040:eb85",57530,"2606:4700:4400::6812:205a",443,1,86,969,0,0,1,86,0,0,5305.118833,0,"",""
"2001:14ba:a051:8c00:ad01:ffd8:f040:eb85",57531,"2606:4700:4400::6812:205a",443,1,86,970,0,0,1,86,0,0,5305.335336,0,"",""
"192.168.1.177",57532,"104.18.32.90",443,33,23018,971,0,0,14,1952,19,21066,5305.426383,48.40166800000043,322,3481
"192.168.1.177",57533,"104.18.32.90",443,14,2139,972,0,0,8,1067,6,1072,5305.642593,48.18477500000063,177,177
"2001:14ba:a051:8c00:ad01:ffd8:f040:eb85",57534,"2600:9000:25f7:5200:1d:8345:69c0:93a1",443,1,86,973,0,0,1,86,0,0,5307.792753,0,"",""
"2001:14ba:a051:8c00:ad01:ffd8:f040:eb85",57535,"2600:9000:25f7:5200:1d:8345:69c0:93a1",443,1,86,974,0,0,1,86,0,0,5307.793122,0,"",""
"2001:14ba:a051:8c00:ad01:ffd8:f040:eb85",57536,"2600:9000:25f7:5200:1d:8345:69c0:93a1",443,1,86,975,0,0,1,86,0,0,5307.793417,0,"",""
"2001:14ba:a051:8c00:ad01:ffd8:f040:eb85",57537,"2600:9000:25f7:5200:1d:8345:69c0:93a1",443,1,86,976,0,0,1,86,0,0,5307.937652,0,"",""
"2001:14ba:a051:8c00:ad01:ffd8:f040:eb85",57538,"2600:9000:25f7:5200:1d:8345:69c0:93a1",443,1,86,977,0,0,1,86,0,0,5308.02265,0,"",""
"192.168.1.177",57539,"18.165.140.68",443,67,219789,978,0,0,29,3222,38,216567,5308.102238,45.72506399999929,563,37890
"192.168.1.177",57540,"18.165.140.68",443,18,7708,979,0,0,8,1025,10,6683,5308.103316,0.01614900000004127,507771,3310669
"192.168.1.177",57541,"18.165.140.68",443,19,7824,980,0,0,8,1025,11,6799,5308.103595,0.015810000000783475,518659,3440354
"192.168.1.177",57542,"18.165.140.68",443,16,1924,981,0,0,8,1026,8,898,5308.334794,45.49190300000009,180,157
"2001:14ba:a051:8c00:ad01:ffd8:f040:eb85",57543,"2a00:1450:4026:805::200a",443,1,86,982,0,0,1,86,0,0,5308.661821,0,"",""
"192.168.1.177",57544,"108.156.22.13",443,29,16150,983,0,0,14,1909,15,14241,5308.679885,45.147549000000254,338,2523
"2001:14ba:a051:8c00:ad01:ffd8:f040:eb85",57545,"2a00:1450:4026:805::200a",443,1,86,984,0,0,1,86,0,0,5308.914425,0,"",""
"192.168.1.177",57546,"216.58.210.170",443,61,12512,985,0,0,26,3485,35,9027,5308.967773,44.860045999999784,621,1609
"192.168.1.177",57547,"216.58.210.170",443,12,2927,986,0,0,7,1263,5,1664,5309.228302,44.598205999999664,226,298
"192.168.1.177",57550,"108.156.22.39",443,39,48697,987,0,0,18,2736,21,45961,5310.152073,43.67583899999954,501,8418
"2001:14ba:a051:8c00:ad01:ffd8:f040:eb85",57551,"2a02:26f0:e2::6854:98e9",443,1,86,988,0,0,1,86,0,0,5310.613053,0,"",""
"2001:14ba:a051:8c00:ad01:ffd8:f040:eb85",57552,"2a02:26f0:e2::6854:98e9",443,1,86,989,0,0,1,86,0,0,5310.855346,0,"",""
"192.168.1.177",57553,"2.21.240.165",443,69,104426,990,0,0,28,3088,41,101338,5310.918207,43.10145100000045,573,18809
"2001:14ba:a051:8c00:ad01:ffd8:f040:eb85",57554,"2a02:26f0:1200:287::f09",443,1,86,991,0,0,1,86,0,0,5311.153899,0,"",""
"192.168.1.177",57555,"2.21.240.165",443,16,2204,992,0,0,7,1092,9,1112,5311.171197,10.799780000000283,808,823
"2001:14ba:a051:8c00:ad01:ffd8:f040:eb85",57556,"2a02:26f0:1200:287::f09",443,1,86,993,0,0,1,86,0,0,5311.390887,0,"",""
"192.168.1.177",57557,"23.61.233.27",443,28,7947,994,0,0,13,1979,15,5968,5311.468064,42.36001100000067,373,1127
"192.168.1.177",57558,"23.61.233.27",443,16,2207,995,0,0,7,1095,9,1112,5311.704229,10.266748000000007,853,866
"2001:14ba:a051:8c00:ad01:ffd8:f040:eb85",57561,"2606:50c0:8001::153",443,1,86,996,0,0,1,86,0,0,5312.93058,0,"",""
"2001:14ba:a051:8c00:ad01:ffd8:f040:eb85",57562,"2606:50c0:8001::153",443,1,86,997,0,0,1,86,0,0,5313.164185,0,"",""
"192.168.1.177",57563,"185.199.111.153",443,54,65503,998,0,0,22,2588,32,62915,5313.24269,40.592437000000245,510,12399
"192.168.1.177",57564,"185.199.111.153",443,13,1810,999,0,0,6,943,7,867,5313.476062,40.35060599999997,186,171
"2001:14ba:a051:8c00:ad01:ffd8:f040:eb85",57565,"2a01:4f8:1c1e:85b6::1",443,1,86,1000,0,0,1,86,0,0,5314.960626,0,"",""
"2001:14ba:a051:8c00:ad01:ffd8:f040:eb85",57566,"2606:4700:4400::ac40:97c7",443,1,86,1001,0,0,1,86,0,0,5314.991038,0,"",""
"192.168.1.177",57567,"40.114.178.124",443,407,2837902,1002,0,0,139,9604,268,2828298,5315.007212,20.61410899999919,3727,1097616
"192.168.1.177",57568,"142.132.209.32",443,28,8308,1003,0,0,13,1952,15,6356,5315.028571,38.81688899999972,402,1309
"2001:14ba:a051:8c00:ad01:ffd8:f040:eb85",57569,"2a01:4f8:1c1e:85b6::1",443,1,86,1004,0,0,1,86,0,0,5315.069453,0,"",""
"2001:14ba:a051:8c00:ad01:ffd8:f040:eb85",57570,"2a01:4f8:1c1e:85b6::1",443,1,86,1005,0,0,1,86,0,0,5315.208359,0,"",""
"2001:14ba:a051:8c00:ad01:ffd8:f040:eb85",57571,"2606:4700:4400::ac40:97c7",443,1,86,1006,0,0,1,86,0,0,5315.213801,0,"",""
"192.168.1.177",57572,"5.75.231.96",443,28,8418,1007,0,0,14,2030,14,6388,5315.269356,38.57989600000019,420,1324
"192.168.1.177",57573,"172.64.151.199",443,34,10568,1008,0,0,17,2536,17,8032,5315.298054,38.52915899999971,526,1667
"2001:14ba:a051:8c00:ad01:ffd8:f040:eb85",57574,"2a01:4f8:1c1e:85b6::1",443,1,86,1009,0,0,1,86,0,0,5315.321568,0,"",""
"192.168.1.177",57575,"5.75.231.96",443,23,7357,1010,0,0,13,1817,10,5540,5315.377503,38.471394000000146,377,1152
"192.168.1.177",57577,"5.75.231.96",443,12,1594,1011,0,0,7,971,5,623,5315.518415,38.32382400000006,202,130
"192.168.1.177",57578,"172.64.151.199",443,12,2029,1012,0,0,7,1007,5,1022,5315.518621,38.30809799999952,210,213
"2001:14ba:a051:8c00:ad01:ffd8:f040:eb85",57579,"2606:4700:3034::ac43:bf1c",443,1,86,1013,0,0,1,86,0,0,5315.564489,0,"",""
"192.168.1.177",57580,"5.75.231.96",443,12,1594,1014,0,0,7,971,5,623,5315.624456,38.21658000000025,203,130
"2001:14ba:a051:8c00:ad01:ffd8:f040:eb85",57581,"2606:4700:3034::ac43:bf1c",443,1,86,1015,0,0,1,86,0,0,5315.794252,0,"",""
"192.168.1.177",57582,"172.67.191.28",443,191,522325,1016,0,0,32,2911,159,519414,5315.871312,37.95594600000004,613,109477
"192.168.1.177",57583,"172.67.191.28",443,14,6152,1017,0,0,8,1056,6,5096,5316.105579,37.72209500000008,223,1080
"2001:14ba:a051:8c00:ad01:ffd8:f040:eb85",57584,"2a04:4e42:3a::347",443,1,86,1018,0,0,1,86,0,0,5318.271612,0,"",""
"2001:14ba:a051:8c00:ad01:ffd8:f040:eb85",57585,"2a04:4e42:3a::347",443,1,86,1019,0,0,1,86,0,0,5318.522718,0,"",""
"192.168.1.177",57586,"151.101.245.91",443,78,277600,1020,0,0,21,2272,57,275328,5318.585334,35.24185299999954,515,62500
"192.168.1.177",57587,"151.101.245.91",443,13,1813,1021,0,0,6,938,7,875,5318.836035,34.99038299999938,214,200
"2001:14ba:a051:8c00:ad01:ffd8:f040:eb85",57588,"2a00:1450:4026:802::200a",443,1,86,1022,0,0,1,86,0,0,5318.900706,0,"",""
"2001:14ba:a051:8c00:ad01:ffd8:f040:eb85",57589,"2a00:1450:4026:802::200a",443,1,86,1023,0,0,1,86,0,0,5318.979979,0,"",""
"2001:14ba:a051:8c00:ad01:ffd8:f040:eb85",57590,"2a00:1450:4026:802::200a",443,1,86,1024,0,0,1,86,0,0,5319.149253,0,"",""
"192.168.1.177",57591,"216.58.209.170",443,56,44581,1025,0,0,21,2526,35,42055,5319.211504,34.61259700000028,583,9720
"2001:14ba:a051:8c00:ad01:ffd8:f040:eb85",57592,"2a00:1450:4026:805::2003",443,1,86,1026,0,0,1,86,0,0,5319.311881,0,"",""
"2001:14ba:a051:8c00:ad01:ffd8:f040:eb85",57593,"2a00:1450:4026:802::200a",443,1,86,1027,0,0,1,86,0,0,5319.31911,0,"",""
"192.168.1.177",57594,"216.58.209.170",443,12,2892,1028,0,0,7,1249,5,1643,5319.460193,34.3639460000004,290,382
"2001:14ba:a051:8c00:ad01:ffd8:f040:eb85",57595,"2a00:1450:4026:805::2003",443,1,86,1029,0,0,1,86,0,0,5319.553307,0,"",""
"2001:14ba:a051:8c00:ad01:ffd8:f040:eb85",57596,"2a00:1450:4026:802::200a",443,1,86,1030,0,0,1,86,0,0,5319.553562,0,"",""
"192.168.1.177",57597,"216.58.209.195",443,28,13132,1031,0,0,14,2090,14,11042,5319.616094,34.21188400000028,488,2582
"192.168.1.177",57598,"216.58.209.170",443,202,123452,1032,0,0,78,16735,124,106717,5319.624197,34.20312699999977,3914,24960
"192.168.1.177",57599,"216.58.209.195",443,12,2847,1033,0,0,7,1231,5,1616,5319.854418,33.97241600000052,289,380
"192.168.1.177",57600,"216.58.209.170",443,12,2892,1034,0,0,7,1249,5,1643,5319.854629,33.97242000000006,294,386
"2001:14ba:a051:8c00:ad01:ffd8:f040:eb85",57601,"2a00:1450:4026:804::2003",443,1,86,1035,0,0,1,86,0,0,5320.010496,0,"",""
"2001:14ba:a051:8c00:ad01:ffd8:f040:eb85",57602,"2a00:1450:4026:804::2003",443,1,86,1036,0,0,1,86,0,0,5320.262044,0,"",""
"192.168.1.177",57603,"216.58.209.163",443,27,12270,1037,0,0,13,2023,14,10247,5320.317598,33.50995300000068,482,2446
"192.168.1.177",57604,"216.58.209.163",443,12,2857,1038,0,0,7,1235,5,1622,5320.573767,33.25276399999984,297,390
"192.168.1.177",57605,"213.230.210.231",443,47,110237,1039,0,0,19,2308,28,107929,5320.739589,15.722373999999945,1174,54917
"2001:14ba:a051:8c00:ad01:ffd8:f040:eb85",57606,"2a02:26f0:1200:2b4::f09",443,1,86,1040,0,0,1,86,0,0,5321.974676,0,"",""
"2001:14ba:a051:8c00:ad01:ffd8:f040:eb85",57607,"2a02:26f0:1200:2b4::f09",443,1,86,1041,0,0,1,86,0,0,5321.97522,0,"",""
"2001:14ba:a051:8c00:ad01:ffd8:f040:eb85",57608,"2a02:26f0:1200:2b4::f09",443,1,86,1042,0,0,1,86,0,0,5322.230789,0,"",""
"2001:14ba:a051:8c00:ad01:ffd8:f040:eb85",57609,"2a02:26f0:1200:2b4::f09",443,1,86,1043,0,0,1,86,0,0,5322.231481,0,"",""
"192.168.1.177",57610,"23.61.233.27",443,28,8056,1044,0,0,12,1867,16,6189,5322.277105,31.551022999999986,473,1569
"192.168.1.177",57611,"23.61.233.27",443,29,7543,1045,0,0,13,1894,16,5649,5322.277277,31.55082500000026,480,1432
"2001:14ba:a051:8c00:ad01:ffd8:f040:eb85",57612,"2a00:1450:4026:805::200a",443,1,86,1046,0,0,1,86,0,0,5322.427364,0,"",""
"192.168.1.177",57613,"23.61.233.27",443,16,2207,1047,0,0,7,1095,9,1112,5322.540013,13.890675999999985,630,640
"192.168.1.177",57614,"23.61.233.27",443,16,2207,1048,0,0,7,1095,9,1112,5322.540463,13.89022599999953,630,640
"2001:14ba:a051:8c00:ad01:ffd8:f040:eb85",57615,"2a00:1450:4026:805::200a",443,1,86,1049,0,0,1,86,0,0,5322.681425,0,"",""
"192.168.1.177",57616,"216.58.211.234",443,81,467261,1050,0,0,30,4038,51,463223,5322.728185,31.099388999999974,1038,119159
"192.168.1.177",57617,"216.58.211.234",443,12,2862,1051,0,0,7,1237,5,1625,5322.995622,30.831191999999646,320,421
"2001:14ba:a051:8c00:ad01:ffd8:f040:eb85",57618,"2600:1901:0:4c10::",443,1,86,1052,0,0,1,86,0,0,5323.080498,0,"",""
"2001:14ba:a051:8c00:ad01:ffd8:f040:eb85",57619,"2600:1901:0:4c10::",443,1,86,1053,0,0,1,86,0,0,5323.327357,0,"",""
"192.168.1.177",57620,"34.160.122.198",443,37,90270,1054,0,0,17,2125,20,88145,5323.3826,30.445244999999886,558,23161
"192.168.1.177",57622,"34.160.122.198",443,12,2076,1055,0,0,7,1028,5,1048,5323.639155,30.187488999999914,272,277
"192.168.1.177",57623,"108.156.22.29",443,27,13270,1056,0,0,13,1900,14,11370,5325.262536,28.565418999999565,532,3184
"2001:14ba:a051:8c00:ad01:ffd8:f040:eb85",57624,"2a00:1450:4026:803::200a",443,1,86,1057,0,0,1,86,0,0,5325.906192,0,"",""
"2001:14ba:a051:8c00:ad01:ffd8:f040:eb85",57625,"2a00:1450:4026:808::200a",443,1,86,1058,0,0,1,86,0,0,5325.95133,0,"",""
"2001:14ba:a051:8c00:ad01:ffd8:f040:eb85",57626,"2a00:1450:4026:803::200a",443,1,86,1059,0,0,1,86,0,0,5326.168581,0,"",""
"2001:14ba:a051:8c00:ad01:ffd8:f040:eb85",57627,"2a00:1450:4026:808::200a",443,1,86,1060,0,0,1,86,0,0,5326.198621,0,"",""
"192.168.1.177",57628,"216.58.210.138",443,5068,34923259,1061,0,0,1430,83868,3638,34839391,5326.213631,27.614067000000432,24297,10093229
"192.168.1.177",57629,"216.58.211.234",443,28,9904,1062,0,0,13,1984,15,7920,5326.260663,27.56727200000023,575,2298
"192.168.1.177",57631,"216.58.210.138",443,12,2947,1063,0,0,7,1271,5,1676,5326.476049,27.350550000000112,371,490
"192.168.1.177",57632,"216.58.211.234",443,12,2872,1064,0,0,7,1241,5,1631,5326.499918,27.326634999999442,363,477
"2001:14ba:a051:8c00:ad01:ffd8:f040:eb85",57633,"2a00:1450:4026:804::2003",443,1,86,1065,0,0,1,86,0,0,5327.191506,0,"",""
"2001:14ba:a051:8c00:ad01:ffd8:f040:eb85",57634,"2a04:4e42:3a::485",443,1,86,1066,0,0,1,86,0,0,5327.262172,0,"",""
"2001:14ba:a051:8c00:ad01:ffd8:f040:eb85",57635,"2a00:1450:4026:804::2003",443,1,86,1067,0,0,1,86,0,0,5327.441955,0,"",""
"192.168.1.177",57636,"216.58.209.163",443,35,74379,1068,0,0,19,2504,16,71875,5327.492639,26.33498099999997,760,21834
"2001:14ba:a051:8c00:ad01:ffd8:f040:eb85",57637,"2a04:4e42:3a::485",443,1,86,1069,0,0,1,86,0,0,5327.510776,0,"",""
"192.168.1.177",57638,"151.101.245.229",443,31,44351,1070,0,0,13,1867,18,42484,5327.562556,26.273173000000497,568,12936
"192.168.1.177",57639,"216.58.209.163",443,12,2857,1071,0,0,7,1235,5,1622,5327.742203,26.08453499999996,378,497
"192.168.1.177",57640,"151.101.245.229",443,13,1804,1072,0,0,6,937,7,867,5327.811138,26.015252000000146,288,266
"2001:14ba:a051:8c00:ad01:ffd8:f040:eb85",57641,"2606:4700:310c::ac42:2f20",443,1,86,1073,0,0,1,86,0,0,5329.825716,0,"",""
"2001:14ba:a051:8c00:ad01:ffd8:f040:eb85",57642,"2606:4700:310c::ac42:2f20",443,1,86,1074,0,0,1,86,0,0,5330.054204,0,"",""
"192.168.1.177",57643,"172.66.47.32",443,127,371928,1075,0,0,31,2894,96,369034,5330.132563,23.695590999999695,977,124591
"192.168.1.177",57644,"40.114.178.124",443,33,8477,1076,0,0,14,2241,19,6236,5330.340093,20.12941099999989,890,2478
"192.168.1.177",57645,"172.66.47.32",443,12,2019,1077,0,0,7,1013,5,1006,5330.368503,23.459523999999874,345,343
"192.168.1.177",57646,"216.58.211.234",443,26,11312,1078,0,0,13,2914,13,8398,5334.498368,0.019215000000258442,1213218,3496435
"2001:14ba:a051:8c00:ad01:ffd8:f040:eb85",57647,"2a05:d018:92c:7103:3856:f8eb:563:1465",443,1,86,1079,0,0,1,86,0,0,5336.429374,0,"",""
"2001:14ba:a051:8c00:ad01:ffd8:f040:eb85",57648,"2a05:d018:92c:7103:3856:f8eb:563:1465",443,1,86,1080,0,0,1,86,0,0,5336.674691,0,"",""
"192.168.1.177",57649,"54.246.51.107",443,26,8753,1081,0,0,12,2064,14,6689,5336.736482,17.12514099999953,964,3124
"192.168.1.177",57650,"54.246.51.107",443,13,1519,1082,0,0,7,958,6,561,5336.984541,16.872980000000098,454,265
"192.168.1.177",57652,"35.185.44.232",443,34,29167,1083,0,0,17,2049,17,27118,5339.739902,5.490689999999631,2985,39511
"2001:14ba:a051:8c00:ad01:ffd8:f040:eb85",57653,"2a02:3d0:640:a000::",80,1,86,1084,0,0,1,86,0,0,5343.637835,0,"",""
"192.168.1.177",57654,"178.79.212.129",80,10,1099,1085,0,0,6,618,4,481,5343.951893,60.0310329999993,82,64
"192.168.1.177",57657,"192.168.1.1",53,11,720,1086,0,0,6,377,5,343,5345.042958,0.03380399999969086,89220,81173
"192.168.1.177",57658,"192.168.1.1",53,11,708,1087,0,0,6,377,5,331,5345.043146,0.0278070000003936,108461,95227
"192.168.1.177",57659,"192.168.1.1",53,11,749,1088,0,0,6,377,5,372,5345.043291,0.03663400000004913,82327,81236
"2001:14ba:a051:8c00:ad01:ffd8:f040:eb85",57662,"2600:1900:4110:86f::",80,1,86,1089,0,0,1,86,0,0,5345.525203,0,"",""
"192.168.1.177",57663,"34.104.35.123",80,2238,8518776,1090,0,0,1034,88632,1204,8430144,5345.834267,268.160989,2644,251495
"2001:14ba:a051:8c00:ad01:ffd8:f040:eb85",57665,"2a01:4f8:1c1e:85b6::1",443,1,86,1091,0,0,1,86,0,0,5356.834542,0,"",""
"2001:14ba:a051:8c00:ad01:ffd8:f040:eb85",57666,"2a01:4f8:1c1e:85b6::1",443,1,86,1092,0,0,1,86,0,0,5357.086962,0,"",""
"192.168.1.177",57667,"5.75.231.96",443,23,7357,1093,0,0,13,1817,10,5540,5357.148796,1.8890409999994517,7694,23461
"192.168.1.177",57668,"5.75.231.96",443,12,1594,1094,0,0,7,971,5,623,5357.396925,1.6408170000004247,4734,3037
"2001:14ba:a051:8c00:ad01:ffd8:f040:eb85",57669,"2a00:1450:4026:808::2003",443,1,86,1095,0,0,1,86,0,0,5358.999303,0,"",""
"2001:14ba:a051:8c00:ad01:ffd8:f040:eb85",57670,"2a00:1450:4026:808::2003",443,1,86,1096,0,0,1,86,0,0,5359.002633,0,"",""
"192.168.1.177",57671,"216.58.211.227",443,155,38599,1097,0,0,72,20192,83,18407,5359.3087,171.83661200000006,940,856
"192.168.1.177",57673,"192.168.1.1",53,11,732,1098,0,0,6,383,5,349,5368.060857,0.03300599999965925,92831,84590
"192.168.1.177",57674,"192.168.1.1",53,11,720,1099,0,0,6,383,5,337,5368.061413,0.023760000000038417,128956,113468
"192.168.1.177",57675,"192.168.1.1",53,11,761,1100,0,0,6,383,5,378,5368.061876,0.05994600000030914,51112,50445
"2001:14ba:a051:8c00:ad01:ffd8:f040:eb85",57676,"2a00:1450:4026:808::200a",443,1,86,1101,0,0,1,86,0,0,5368.10654,0,"",""
"2001:14ba:a051:8c00:ad01:ffd8:f040:eb85",57677,"2a00:1450:4026:808::200a",443,1,86,1102,0,0,1,86,0,0,5368.322625,0,"",""
"192.168.1.177",57678,"216.58.211.234",443,1741,10422733,1103,0,0,656,46185,1085,10376548,5368.414841,162.72872600000028,2270,510127
"192.168.1.177",57679,"216.58.211.234",443,16,3149,1104,0,0,9,1365,7,1784,5368.625148,109.70797399999992,99,130
"192.168.1.177",57682,"34.107.221.82",80,35,3117,1105,0,0,19,1677,16,1440,5384.759198,116.25302199999987,115,99
"2001:14ba:a051:8c00:ad01:ffd8:f040:eb85",57683,"2600:1901:0:38d7::",80,5,430,1106,0,0,5,430,0,0,5384.761832,15.03534099999979,228,0
"2001:14ba:a051:8c00:ad01:ffd8:f040:eb85",57684,"2600:1901:0:38d7::",80,1,86,1107,0,0,1,86,0,0,5384.761959,0,"",""
"2001:14ba:a051:8c00:ad01:ffd8:f040:eb85",57685,"2600:1901:0:38d7::",80,1,86,1108,0,0,1,86,0,0,5385.022407,0,"",""
"192.168.1.177",57686,"34.107.221.82",80,32,2505,1109,0,0,17,1253,15,1252,5385.023071,115.98842400000012,86,86
"2001:14ba:a051:8c00:ad01:ffd8:f040:eb85",57687,"2600:1901:0:38d7::",80,5,430,1110,0,0,5,430,0,0,5385.034821,15.041782999999668,228,0
"192.168.1.177",57688,"149.154.167.99",443,36,10014,1111,0,0,19,2415,17,7599,5385.132934,221.92212000000018,87,273
"2001:14ba:a051:8c00:ad01:ffd8:f040:eb85",57689,"2001:67c:4e8:f004::9",443,5,430,1112,0,0,5,430,0,0,5385.269714,15.041057000000364,228,0
"2001:14ba:a051:8c00:ad01:ffd8:f040:eb85",57690,"2600:1901:0:38d7::",80,5,430,1113,0,0,5,430,0,0,5385.299419,15.042427999999745,228,0
"192.168.1.177",57691,"149.154.167.99",443,1373,225131,1114,0,0,737,107100,636,118031,5385.534817,787.6841400000003,1087,1198
"192.168.1.177",57694,"34.107.221.82",80,6,348,1115,0,0,4,228,2,120,5405.806797,5.578156999999919,326,172
"192.168.1.177",57695,"149.154.167.99",443,20,8815,1116,0,0,9,1903,11,6912,5406.320865,0.11658400000032998,130583,474301
"192.168.1.177",57697,"40.114.178.124",443,28,4116,1117,0,0,12,2078,16,2038,5416.681161,20.125169999999343,826,810
"192.168.1.177",57698,"192.168.1.1",53,11,838,1118,0,0,6,380,5,458,5416.790817,0.04115100000035454,73874,89037
"192.168.1.177",57699,"192.168.1.1",53,11,778,1119,0,0,6,380,5,398,5416.791045,0.0393050000002404,77343,81007
"192.168.1.177",57700,"192.168.1.1",53,10,705,1120,0,0,5,326,5,379,5416.791177,0.02629700000034063,99174,115298
"2001:14ba:a051:8c00:ad01:ffd8:f040:eb85",57701,"2a01:4f8:c012:e655::1",443,1,86,1121,0,0,1,86,0,0,5416.830147,0,"",""
"2001:14ba:a051:8c00:ad01:ffd8:f040:eb85",57702,"2a01:4f8:c012:e655::1",443,1,86,1122,0,0,1,86,0,0,5417.043906,0,"",""
"192.168.1.177",57703,"138.201.94.34",443,36,8511,1123,0,0,18,2253,18,6258,5417.137551,114.03365300000041,158,439
"192.168.1.177",57704,"138.201.94.34",443,15,1769,1124,0,0,8,1026,7,743,5417.354299,68.50172199999997,119,86
"192.168.1.177",57705,"216.58.210.163",443,149,37847,1125,0,0,66,7871,83,29976,5419.718771,738.6712010000001,85,324
"192.168.1.177",57707,"157.240.205.60",443,32,6391,1126,0,0,16,1946,16,4445,5425.687886,171.30658399999993,90,207
"2001:14ba:a051:8c00:ad01:ffd8:f040:eb85",57708,"2a03:2880:f213:c3:face:b00c:0:167",443,5,430,1127,0,0,5,430,0,0,5425.704267,15.046199999999772,228,0
"192.168.1.177",57709,"157.240.205.60",443,211,26276,1128,0,0,103,10942,108,15334,5425.966338,743.5612869999995,117,164
"192.168.1.177",57710,"216.58.211.234",443,162,17945,1129,0,0,68,9516,94,8429,5430.159752,724.1159220000009,105,93
"192.168.1.177",57711,"216.58.211.234",443,250,38546,1130,0,0,104,21904,146,16642,5430.338712,744.5638330000002,235,178
"192.168.1.177",57713,"157.240.205.60",443,14,2321,1131,0,0,7,1512,7,809,5446.765074,0.019406000000344648,623312,333505
"192.168.1.177",57715,"216.58.211.237",443,46,10653,1132,0,0,22,6113,24,4540,5450.398883,171.04029400000036,285,212
"192.168.1.177",50122,"195.148.124.36",80,10,1226,1133,0,0,6,504,4,722,5468.873715,0.014263000000028114,282689,404963
"192.168.1.177",50158,"188.166.241.168",80,10,1228,1134,0,0,6,505,4,723,5475.588182,0.8525349999999889,4738,6784
"192.168.1.177",57718,"192.168.1.1",53,11,668,1135,0,0,6,365,5,303,5478.330877,0.04151599999931932,70334,58387
"192.168.1.177",57719,"192.168.1.1",53,11,684,1136,0,0,6,365,5,319,5478.331022,0.027106999999887194,107721,94145
"192.168.1.177",57720,"192.168.1.1",53,11,668,1137,0,0,6,365,5,303,5478.331147,0.025152000000161934,116094,96374
"192.168.1.177",57724,"192.168.1.1",53,11,668,1138,0,0,6,365,5,303,5485.822591,0.024908999999752268,117226,97314
"192.168.1.177",57725,"192.168.1.1",53,11,684,1139,0,0,6,365,5,319,5485.822721,0.037651000000550994,77554,67780
"192.168.1.177",57726,"192.168.1.1",53,11,668,1140,0,0,6,365,5,303,5485.822837,0.020414999999957217,143032,118736
"192.168.1.177",57730,"216.58.210.133",443,221,101823,1141,0,0,102,42703,119,59120,5495.819667,678.3193160000001,503,697
"192.168.1.177",57735,"34.120.52.64",443,41,9729,1142,0,0,20,2633,21,7096,5518.114975,170.83996599999955,123,332
"192.168.1.177",57736,"34.120.52.64",443,104,17954,1143,0,0,38,5101,66,12853,5518.307815,653.0785669999996,62,157
"192.168.1.177",57739,"35.186.227.140",443,494,181563,1144,0,0,208,150252,286,31311,5538.470153,630.6063359999998,1906,397
"192.168.1.177",57740,"34.110.207.168",443,49,10593,1145,0,0,25,4385,24,6208,5538.472222,293.9400179999993,119,168
"2001:14ba:a051:8c00:ad01:ffd8:f040:eb85",57742,"2a00:1450:4026:802::2003",443,1,86,1146,0,0,1,86,0,0,5549.221346,0,"",""
"192.168.1.177",57743,"216.58.209.195",443,280,260710,1147,0,0,99,33164,181,227546,5549.483465,284.95076599999993,931,6388
"192.168.1.177",57749,"104.18.37.228",443,37,13332,1148,0,0,20,6249,17,7083,5612.132211,171.1378509999995,292,331
"192.168.1.177",57750,"34.196.123.226",443,40,12089,1149,0,0,20,3434,20,8655,5612.80247,171.9559960000006,159,402
"192.168.1.177",57754,"40.114.177.156",443,112,38089,1150,0,0,47,5744,65,32345,5637.158719,32.52792800000043,1412,7955
"192.168.1.177",57755,"40.114.177.156",443,103,120506,1151,0,0,33,4030,70,116476,5641.074118,21.549668999999994,1496,43240
"192.168.1.177",57756,"40.114.177.156",443,33,9506,1152,0,0,14,2055,19,7451,5641.217002,20.111786999999822,817,2963
"192.168.1.177",57757,"34.120.208.123",443,20,5456,1153,0,0,10,1081,10,4375,5641.405961,0.03631599999971513,238131,963762
"192.168.1.177",57758,"34.120.208.123",443,48,8691,1154,0,0,23,5139,25,3552,5641.407086,171.3742199999997,239,165
"192.168.1.177",57759,"20.103.36.96",443,31,14529,1155,0,0,16,2366,15,12163,5641.463629,20.914834000000155,905,4652
"192.168.1.177",57760,"34.117.237.239",443,32,4653,1156,0,0,17,2758,15,1895,5642.177329,170.60390000000007,129,88
"192.168.1.177",57761,"40.114.178.124",443,51,29296,1157,0,0,22,3015,29,26281,5642.47157,20.11473500000011,1199,10452
"192.168.1.177",57763,"216.58.210.174",443,967,509346,1158,0,0,353,191278,614,318068,5650.837752,252.90235099999973,6050,10061
"192.168.1.177",57764,"216.58.211.237",443,45,10763,1159,0,0,21,5993,24,4770,5655.814255,170.5517749999999,281,223
"192.168.1.177",57766,"159.69.190.238",443,110,25080,1160,0,0,59,11002,51,14078,5658.232852,246.54453000000012,356,456
"2001:14ba:a051:8c00:ad01:ffd8:f040:eb85",57767,"2606:4700:4400::ac40:97c7",443,1,86,1161,0,0,1,86,0,0,5658.271816,0,"",""
"192.168.1.177",57768,"142.132.209.32",443,33,8881,1162,0,0,14,2246,19,6635,5658.272999,42.8169969999999,419,1239
"192.168.1.177",57769,"172.64.151.199",443,35,10610,1163,0,0,19,2827,16,7783,5658.529691,170.63670100000036,132,364
"192.168.1.177",57775,"185.179.237.109",443,37,12690,1164,0,0,15,3999,22,8691,5713.481133,6.892385000000104,4641,10087
"192.168.1.177",57776,"20.54.232.160",443,26,15458,1165,0,0,15,5930,11,9528,5719.538492,89.26918999999998,531,853
"2001:14ba:a051:8c00:ad01:ffd8:f040:eb85",57778,"2a05:d014:58f:6201::64",80,5,430,1166,0,0,5,430,0,0,5726.492256,15.029898999999205,228,0
"192.168.1.177",57780,"149.154.167.99",443,36,9977,1167,0,0,17,2302,19,7675,5736.572596,170.55630500000007,107,359
"2001:14ba:a051:8c00:ad01:ffd8:f040:eb85",57782,"2a05:d014:275:cb01::c8",80,5,430,1168,0,0,5,430,0,0,5747.536666,15.023371999999654,228,0
"192.168.1.177",57784,"185.179.237.109",443,19,5178,1169,0,0,9,3081,10,2097,5758.23795,5.025722000000314,4904,3338
"192.168.1.177",57786,"52.58.254.253",80,15,1268,1170,0,0,8,553,7,715,5768.575034,67.88020199999937,65,84
"192.168.1.177",57787,"52.58.254.253",443,26,6537,1171,0,0,13,1326,13,5211,5768.638476,67.81730799999968,156,614
"2001:14ba:a051:8c00:ad01:ffd8:f040:eb85",57789,"2001:b28:f23d:8007::805:532",443,5,430,1172,0,0,5,430,0,0,5784.654394,15.043163000000277,228,0
"192.168.1.177",57790,"149.154.174.200",443,52,26517,1173,0,0,18,2891,34,23626,5784.918163,31.250364999999874,740,6048
"192.168.1.177",57792,"152.199.20.80",443,24,7072,1174,0,0,13,1295,11,5777,5796.039224,0.058277999999518215,177768,793026
"192.168.1.177",57793,"152.199.20.80",443,24,7057,1175,0,0,12,1238,12,5819,5796.493906,0.047118000000409666,210195,987987
"192.168.1.177",57795,"149.154.174.200",443,16,2861,1176,0,0,8,1854,8,1007,5805.712037,0.43899899999996705,33785,18350
"192.168.1.177",57796,"149.154.167.99",443,60,55646,1177,0,0,21,3290,39,52356,5806.538183,30.347741000000497,867,13801
"2001:14ba:a051:8c00:ad01:ffd8:f040:eb85",57800,"2a02:26f0:41:385::2c1a",80,1,86,1178,0,0,1,86,0,0,5833.488862,0,"",""
"192.168.1.177",57801,"2.18.74.119",80,14,3516,1179,0,0,7,2830,7,686,5833.790568,0.024012999999285967,942822,228542
"192.168.1.177",57802,"52.142.223.178",80,13,5257,1180,0,0,7,2823,6,2434,5833.849139,45.18914700000005,499,430
"192.168.1.177",57804,"34.110.207.168",443,32,5722,1181,0,0,17,3574,15,2148,5851.219602,170.46405799999957,167,100
"192.168.1.177",57806,"130.233.229.20",443,22,7831,1182,0,0,11,2350,11,5481,5861.421678,4.087840000000142,4599,10726
"192.168.1.177",57807,"34.120.52.64",443,36,6483,1183,0,0,19,3751,17,2732,5864.769368,170.15453499999967,176,128
"192.168.1.177",57808,"140.82.121.6",443,23,6670,1184,0,0,13,1221,10,5449,5865.549072,109.98590500000046,88,396
"192.168.1.177",57810,"130.233.229.20",443,20,4541,1185,0,0,10,3016,10,1525,5866.666209,4.080238000000463,5913,2990
"2001:14ba:a051:8c00:ad01:ffd8:f040:eb85",57811,"2a00:1450:4026:804::2001",443,1,86,1186,0,0,1,86,0,0,5874.758304,0,"",""
"192.168.1.177",57812,"216.58.210.129",443,70,245265,1187,0,0,35,3430,35,241835,5875.039176,170.53707699999995,160,11344
"2001:14ba:a051:8c00:ad01:ffd8:f040:eb85",57815,"2a02:26f0:41:385::2c1a",80,1,86,1188,0,0,1,86,0,0,5887.228158,0,"",""
"192.168.1.177",57816,"2.18.74.119",80,16,4902,1189,0,0,8,4162,8,740,5887.541473,0.026764999999613792,1244012,221184
"192.168.1.177",57817,"52.142.223.178",80,26,13046,1190,0,0,13,8136,13,4910,5887.565684,45.34920299999976,1435,866
"192.168.1.177",57818,"2.18.74.119",80,16,4902,1191,0,0,8,4162,8,740,5887.785686,0.026350999999522173,1263557,224659
"192.168.1.177",57821,"130.233.229.20",443,20,4472,1192,0,0,10,2931,10,1541,5891.666946,4.071632999999565,5758,3027
"192.168.1.177",57823,"130.233.229.20",443,19,4990,1193,0,0,10,3508,9,1482,5907.312507,4.055811000000176,6919,2923
"192.168.1.177",57826,"130.233.229.20",443,20,4472,1194,0,0,10,2931,10,1541,5921.995544,4.070909999999458,5759,3028
"2001:14ba:a051:8c00:ad01:ffd8:f040:eb85",57828,"2600:1901:1:81::",443,1,86,1195,0,0,1,86,0,0,5934.427177,0,"",""
"2001:14ba:a051:8c00:ad01:ffd8:f040:eb85",57829,"2600:1901:1:81::",443,1,86,1196,0,0,1,86,0,0,5934.678525,0,"",""
"192.168.1.177",57830,"35.186.224.17",443,133,26542,1197,0,0,63,16602,70,9940,5934.741861,224.54492299999947,591,354
"192.168.1.177",57831,"35.186.224.17",443,19,2528,1198,0,0,10,1204,9,1324,5934.985449,225.05834700000014,42,47
"192.168.1.177",57832,"68.232.34.52",443,24,18781,1199,0,0,10,1236,14,17545,5937.376254,0.9407940000000963,10510,149193
"192.168.1.177",57833,"68.232.34.52",443,20,7604,1200,0,0,9,1557,11,6047,5938.702324,0.8804090000003271,14147,54947
"192.168.1.177",57834,"185.136.68.145",443,22,6460,1201,0,0,9,1957,13,4503,5939.427864,16.080203999999867,973,2240
"192.168.1.177",57835,"185.136.68.145",443,22,6652,1202,0,0,9,2149,13,4503,5940.736911,3.0783480000000054,5584,11702
"192.168.1.177",57837,"157.240.205.60",443,42,12257,1203,0,0,20,2574,22,9683,5944.614302,170.36174200000005,120,454
"192.168.1.177",57838,"130.233.229.20",443,20,4472,1204,0,0,10,2931,10,1541,5952.284368,4.072755000000143,5757,3026
"2001:14ba:a051:8c00:ad01:ffd8:f040:eb85",57841,"2600:1901:1:c36::",443,5,430,1205,0,0,5,430,0,0,5957.321569,15.040393000000222,228,0
"2001:14ba:a051:8c00:ad01:ffd8:f040:eb85",57842,"2600:1901:1:c36::",443,5,430,1206,0,0,5,430,0,0,5957.32157,15.040382000000136,228,0
"2001:14ba:a051:8c00:ad01:ffd8:f040:eb85",57840,"2600:1901:1:c36::",443,5,430,1207,0,0,5,430,0,0,5957.32157,15.040358999999626,228,0
"2001:14ba:a051:8c00:ad01:ffd8:f040:eb85",57843,"2600:1901:1:c36::",443,5,430,1208,0,0,5,430,0,0,5957.321694,15.04027700000006,228,0
"2001:14ba:a051:8c00:ad01:ffd8:f040:eb85",57844,"2600:1901:1:c36::",443,5,430,1209,0,0,5,430,0,0,5957.322087,15.039850000000115,228,0
"192.168.1.177",57845,"185.136.68.145",443,24,7928,1210,0,0,10,3371,14,4557,5963.787844,3.0799389999992854,8756,11836
"192.168.1.177",57847,"130.233.229.20",443,19,4907,1211,0,0,10,3425,9,1482,5967.31829,4.051930999999968,6762,2926
"192.168.1.177",57850,"35.186.224.25",443,19,7286,1212,0,0,9,990,10,6296,5978.364396,60.08075000000008,131,838
"192.168.1.177",57851,"35.186.224.25",443,19,7328,1213,0,0,9,990,10,6338,5978.364432,60.08065399999941,131,843
"192.168.1.177",57849,"35.186.224.25",443,19,7281,1214,0,0,9,990,10,6291,5978.36446,60.08073400000012,131,837
"192.168.1.177",57852,"35.186.224.25",443,19,7286,1215,0,0,9,990,10,6296,5978.364462,60.0807790000008,131,838
"192.168.1.177",57853,"35.186.224.25",443,19,7328,1216,0,0,9,990,10,6338,5978.364474,60.08052899999984,131,843
"192.168.1.177",57854,"130.233.229.20",443,19,4430,1217,0,0,10,2931,9,1499,5982.581901,4.066322000000582,5766,2949
"192.168.1.177",57858,"130.233.229.20",443,20,4472,1218,0,0,10,2931,10,1541,6012.916044,4.093344000000798,5728,3011
"192.168.1.177",57859,"13.107.5.88",443,18,7413,1219,0,0,8,1674,10,5739,6019.238154,63.97976800000015,209,717
"192.168.1.177",57862,"149.154.167.99",443,30,10231,1220,0,0,15,2750,15,7481,6037.346367,116.87711200000012,188,512
"192.168.1.177",57864,"130.233.229.20",443,20,4472,1221,0,0,10,2931,10,1541,6047.248835,4.068174999999428,5763,3030
"192.168.1.177",57865,"216.58.211.237",443,40,10359,1222,0,0,19,5907,21,4452,6051.52122,117.08913600000051,403,304
"192.168.1.177",50146,"195.148.124.36",5207,30,2743,1223,0,0,17,1567,13,1176,6063.622565,10.21022400000038,1227,921
"192.168.1.177",50158,"195.148.124.36",80,1389,10577992,1224,0,0,353,23596,1036,10554396,6063.625748,0.5251719999996567,359440,160776218
"192.168.1.177",50154,"195.148.124.36",5207,92599,116147923,1225,0,0,75979,115023563,16620,1124360,6063.682545,10.05563600000005,91509726,894511
"192.168.1.177",50064,"188.166.241.168",80,2857,10676877,1226,0,0,516,36351,2341,10640526,6064.151685,4.51952700000038,64344,18834760
"192.168.1.177",57868,"34.120.208.123",443,26,6030,1227,0,0,13,3747,13,2283,6066.463285,59.16756600000008,506,308
"192.168.1.177",50102,"195.148.124.138",443,28,9874,1228,0,0,16,1808,12,8066,6067.596825,0.19429000000036467,74445,332122
"192.168.1.177",50124,"195.148.124.36",80,10,1226,1229,0,0,6,504,4,722,6067.640188,0.02223099999991973,181368,259817
"192.168.1.177",57869,"34.110.207.168",443,22,5041,1230,0,0,11,3148,11,1893,6071.327768,59.24828900000011,425,255
"192.168.1.177",50106,"195.148.124.138",443,24,9582,1231,0,0,13,1610,11,7972,6071.816131,0.13404500000069675,96087,475780
"192.168.1.177",50134,"195.148.124.36",5203,30,2761,1232,0,0,17,1580,13,1181,6074.236812,10.23427300000003,1235,923
"192.168.1.177",50130,"188.166.241.168",80,10,1228,1233,0,0,6,505,4,723,6074.31963,0.8576599999996688,4710,6743
"192.168.1.177",50144,"195.148.124.36",5203,20587,248932251,1234,0,0,6002,397833,14585,248534418,6074.320455,10.147759000000406,313632,195932456
"192.168.1.177",50148,"195.148.124.138",443,28,10099,1235,0,0,16,1796,12,8303,6076.940638,15.167661000000408,947,4379
"192.168.1.177",57871,"130.233.229.20",443,20,4472,1236,0,0,10,2931,10,1541,6078.561004,4.096024999999827,5724,3009
"192.168.1.177",50088,"188.166.241.168",5209,35,3077,1237,0,0,19,1706,16,1371,6084.473307,13.158599999999751,1037,833
"192.168.1.177",50092,"188.166.241.168",5209,1410,1409189,1238,0,0,912,1376469,498,32720,6085.624121,11.09586600000057,992419,23590
"192.168.1.177",57872,"152.199.20.202",443,20,6780,1239,0,0,11,1487,9,5293,6086.836852,0.31590999999934866,37656,134038
"192.168.1.177",50152,"188.166.241.168",5204,33,2946,1240,0,0,18,1645,15,1301,6097.365041,13.223735999999917,995,787
"192.168.1.177",50156,"188.166.241.168",5204,6193,65162851,1241,0,0,2023,135831,4170,65027020,6098.531887,11.775494999999864,92280,44177859
"192.168.1.177",57875,"130.233.229.20",443,20,4472,1242,0,0,10,2931,10,1541,6108.869003,4.076673999999912,5751,3024
"192.168.1.177",57878,"216.58.210.174",443,60,20519,1243,0,0,27,12777,33,7742,6123.439788,0.09132500000032451,1119255,678193
"192.168.1.177",57879,"52.184.217.20",443,21,5572,1244,0,0,12,1973,9,3599,6123.992231,0.5173329999997804,30510,55654
"192.168.1.177",57880,"162.55.83.113",443,46,12709,1245,0,0,23,4938,23,7771,6125.610009,9.661323999999695,4088,6434
"192.168.1.177",57881,"130.233.229.20",443,19871,27036749,1246,0,0,15871,23628593,4000,3408156,6127.360555,6.195737000000008,30509484,4400646
"192.168.1.177",57883,"130.233.229.20",443,754,3140297,1247,0,0,220,15638,534,3124659,6133.302103,0.32669199999963894,382941,76516327
"192.168.1.177",57884,"130.233.229.20",443,647,2955301,1248,0,0,200,13454,447,2941847,6133.303432,0.4435320000002321,242670,53062182
"192.168.1.177",57886,"20.190.181.3",443,24,23252,1249,0,0,13,6268,11,16984,6143.641318,0.3654450000003635,137213,371798
"192.168.1.177",57887,"130.233.229.20",443,20,18753,1250,0,0,11,4096,9,14657,6144.135181,3.2068490000001475,10218,36564
"192.168.1.177",57888,"130.233.229.20",443,21,19685,1251,0,0,11,4979,10,14706,6147.349701,2.6876499999998487,14820,43773
"192.168.1.177",57889,"130.233.229.20",443,93,309688,1252,0,0,27,8222,66,301466,6150.06606,2.0827289999997447,31581,1157965
"192.168.1.177",57890,"52.85.49.50",443,21,8935,1253,0,0,10,1823,11,7112,6151.701614,0.10202900000058435,142939,557645
"192.168.1.177",57891,"130.233.229.20",443,154,1010599,1254,0,0,48,6267,106,1004332,6152.480494,5.008106999999654,10010,1604329
"192.168.1.177",57892,"130.233.229.20",443,159,952009,1255,0,0,55,5379,104,946630,6152.484492,4.1914090000000215,10266,1806800
"192.168.1.177",57893,"130.233.229.20",443,128,953597,1256,0,0,52,4588,76,949009,6152.491151,4.218431000000237,8700,1799738
"192.168.1.177",57894,"130.233.229.20",443,22,8287,1257,0,0,11,2811,11,5476,6152.496168,4.162859000000026,5402,10523
"192.168.1.177",57896,"62.183.170.16",443,23,8314,1258,0,0,11,2066,12,6248,6158.80739,0.9263970000001791,17841,53955
"192.168.1.177",57897,"54.246.205.176",443,23,9244,1259,0,0,11,1802,12,7442,6162.82013,0.8900430000003325,16196,66891
"192.168.1.177",57898,"54.246.205.176",443,14,2798,1260,0,0,6,1627,8,1171,6163.669508,0.2602520000000368,50013,35995
