Address,Port,Packets,Bytes,Total Packets,Percent Filtered,Tx Packets,Tx Bytes,Rx Packets,Rx Bytes,Country,City,AS Number,AS Organization
192.168.1.177,0,404509,1097708926,0,0,246978,279642821,157531,818066105,,,,
192.229.221.95,0,109,12729,0,0,50,7347,59,5382,,,,
35.186.224.17,0,8917,1828034,0,0,5162,970725,3755,857309,,,,
216.58.211.227,0,946,329912,0,0,529,262453,417,67459,,,,
62.183.170.50,0,370,36457,0,0,174,20849,196,15608,,,,
192.168.1.1,0,8922,2486884,0,0,7267,2352234,1655,134650,,,,
239.255.255.250,0,6288,2410461,0,0,0,0,6288,2410461,,,,
40.101.1.15,0,1,54,0,0,1,54,0,0,,,,
216.58.210.138,0,8723,35352010,0,0,5781,35118467,2942,233543,,,,
35.186.224.41,0,1620,117695,0,0,810,58140,810,59555,,,,
157.240.205.60,0,1557,199693,0,0,789,115801,768,83892,,,,
35.186.224.25,0,3895,813760,0,0,2096,380105,1799,433655,,,,
108.156.15.108,0,26,1534,0,0,12,768,14,766,,,,
162.254.198.44,0,2341,243603,0,0,1173,162565,1168,81038,,,,
34.107.221.82,0,119,8714,0,0,55,4240,64,4474,,,,
192.168.1.62,0,22198,1791720,0,0,21841,1771014,357,20706,,,,
224.0.0.251,0,8262,662282,0,0,0,0,8262,662282,,,,
224.0.0.252,0,7721,562669,0,0,0,0,7721,562669,,,,
192.168.1.255,0,6041,555739,0,0,0,0,6041,555739,,,,
20.199.120.151,0,313,46393,0,0,105,24097,208,22296,,,,
40.114.177.156,0,725,393455,0,0,427,353583,298,39872,,,,
34.120.52.64,0,5359,2236640,0,0,3368,1962339,1991,274301,,,,
34.120.208.123,0,741,150483,0,0,384,65359,357,85124,,,,
35.241.46.245,0,461,574046,0,0,424,566724,37,7322,,,,
192.168.1.210,0,169,21889,0,0,169,21889,0,0,,,,
149.154.167.99,0,21965,16176550,0,0,10992,13988456,10973,2188094,,,,
192.124.249.22,0,104,24286,0,0,52,18848,52,5438,,,,
224.0.0.22,0,435,25146,0,0,0,0,435,25146,,,,
35.186.227.140,0,10797,5796606,0,0,5779,564825,5018,5231781,,,,
213.141.122.228,0,26,3918,0,0,12,2358,14,1560,,,,
34.158.0.131,0,300,28191,0,0,117,8221,183,19970,,,,
224.0.0.1,0,179,8950,0,0,0,0,179,8950,,,,
162.55.83.113,0,1297,345550,0,0,682,178889,615,166661,,,,
34.117.138.150,0,4316,3444761,0,0,3351,3241039,965,203722,,,,
0.0.0.0,0,104,6096,0,0,104,6096,0,0,,,,
34.117.14.220,0,57,18908,0,0,30,10713,27,8195,,,,
34.160.144.191,0,96,24237,0,0,50,18907,46,5330,,,,
34.117.237.239,0,237,33414,0,0,112,13682,125,19732,,,,
34.117.65.55,0,127,17686,0,0,73,10911,54,6775,,,,
34.149.100.209,0,182,99232,0,0,96,90152,86,9080,,,,
34.110.207.168,0,716,152446,0,0,346,62284,370,90162,,,,
34.107.141.31,0,56,22322,0,0,29,14518,27,7804,,,,
35.244.181.201,0,58,8959,0,0,28,6025,30,2934,,,,
18.165.122.14,0,9,655,0,0,3,208,6,447,,,,
159.69.148.181,0,10,705,0,0,4,279,6,426,,,,
151.101.246.248,0,4899,26097792,0,0,3156,25952127,1743,145665,,,,
172.64.154.86,0,9,627,0,0,3,201,6,426,,,,
108.156.22.78,0,19,1308,0,0,7,456,12,852,,,,
3.214.211.112,0,11,735,0,0,5,309,6,426,,,,
13.107.213.53,0,37,11086,0,0,20,9209,17,1877,,,,
104.18.37.228,0,46,13959,0,0,20,7284,26,6675,,,,
150.171.22.254,0,1,54,0,0,1,54,0,0,,,,
13.107.6.254,0,1,54,0,0,1,54,0,0,,,,
195.148.124.36,0,236049,759205580,0,0,67732,523971475,168317,235234105,,,,
84.88.81.122,0,110,10780,0,0,55,5390,55,5390,,,,
188.166.241.168,0,24543,145469727,0,0,16249,140081101,8294,5388626,,,,
202.90.158.5,0,110,10780,0,0,55,5390,55,5390,,,,
13.107.246.53,0,10,617,0,0,2,185,8,432,,,,
205.166.205.222,0,110,10780,0,0,55,5390,55,5390,,,,
52.108.8.254,0,31,10434,0,0,19,8540,12,1894,,,,
52.97.200.146,0,1,54,0,0,1,54,0,0,,,,
192.168.1.253,0,216,46992,0,0,216,46992,0,0,,,,
104.123.68.49,0,10,571,0,0,2,139,8,432,,,,
20.189.173.9,0,1,54,0,0,1,54,0,0,,,,
149.154.170.200,0,432,1401286,0,0,259,1377661,173,23625,,,,
62.165.159.17,0,10,571,0,0,2,139,8,432,,,,
204.79.197.222,0,26,10077,0,0,15,7758,11,2319,,,,
104.123.68.50,0,10,571,0,0,2,139,8,432,,,,
13.107.18.254,0,1,54,0,0,1,54,0,0,,,,
152.199.19.161,0,11,689,0,0,3,257,8,432,,,,
3.70.101.28,0,121,23306,0,0,56,17561,65,5745,,,,
62.165.155.56,0,125,39636,0,0,64,28320,61,11316,,,,
95.216.67.183,0,80,23512,0,0,43,17982,37,5530,,,,
20.42.65.89,0,36,12131,0,0,17,6086,19,6045,,,,
192.168.1.103,0,133,15491,0,0,133,15491,0,0,,,,
140.177.50.10,0,466,852296,0,0,308,824968,158,27328,,,,
157.124.1.11,0,535,389968,0,0,292,283418,243,106550,,,,
23.72.246.32,0,39,4690,0,0,18,3087,21,1603,,,,
130.233.229.20,0,24869,42346129,0,0,6644,16981384,18225,25364745,,,,
52.85.49.37,0,40,10202,0,0,21,7752,19,2450,,,,
185.76.9.23,0,38,13506,0,0,19,11062,19,2444,,,,
130.233.224.114,0,128,124221,0,0,65,81658,63,42563,,,,
20.190.181.0,0,117,96805,0,0,55,53001,62,43804,,,,
130.233.0.8,0,93,89052,0,0,38,45310,55,43742,,,,
104.18.15.101,0,38,3906,0,0,17,2296,21,1610,,,,
216.58.209.170,0,747,481797,0,0,435,426119,312,55678,,,,
216.58.209.174,0,153,41262,0,0,76,29607,77,11655,,,,
162.55.98.14,0,1150,300504,0,0,597,138970,553,161534,,,,
2.22.244.241,0,32,12464,0,0,16,8838,16,3626,,,,
178.79.212.129,0,21,2251,0,0,9,1015,12,1236,,,,
40.114.178.124,0,791,2988267,0,0,478,2953960,313,34307,,,,
216.58.211.234,0,2997,11389162,0,0,1778,11245762,1219,143400,,,,
40.127.240.158,0,23,7279,0,0,11,5101,12,2178,,,,
62.165.159.8,0,405,653142,0,0,265,635666,140,17476,,,,
62.165.159.41,0,528,989544,0,0,324,967054,204,22490,,,,
149.154.174.200,0,191,253380,0,0,116,240178,75,13202,,,,
94.130.182.214,0,238,71359,0,0,115,29943,123,41416,,,,
20.54.232.160,0,118,73028,0,0,53,42582,65,30446,,,,
142.132.209.32,0,150,42689,0,0,84,32346,66,10343,,,,
172.64.151.199,0,271,361779,0,0,157,342663,114,19116,,,,
91.107.148.202,0,66,18223,0,0,33,12250,33,5973,,,,
20.103.36.96,0,63,35693,0,0,31,30680,32,5013,,,,
185.179.237.109,0,405,155592,0,0,222,103061,183,52531,,,,
216.58.210.163,0,287,51000,0,0,147,37059,140,13941,,,,
193.176.144.22,0,20,1960,0,0,10,980,10,980,,,,
195.148.124.138,0,162,59447,0,0,73,49109,89,10338,,,,
194.0.36.1,0,20,1960,0,0,10,980,10,980,,,,
194.146.106.46,0,20,1960,0,0,10,980,10,980,,,,
213.239.220.37,0,156,34791,0,0,83,20731,73,14060,,,,
3.72.140.173,0,115,15070,0,0,53,9571,62,5499,,,,
52.184.216.226,0,24,5738,0,0,10,3653,14,2085,,,,
185.136.68.153,0,110,32423,0,0,65,24050,45,8373,,,,
68.232.34.52,0,63,35004,0,0,35,30840,28,4164,,,,
20.190.177.23,0,24,30089,0,0,10,21821,14,8268,,,,
52.184.217.20,0,42,11083,0,0,19,7191,23,3892,,,,
20.189.173.18,0,31,8788,0,0,17,5907,14,2881,,,,
104.84.152.10,0,29,32835,0,0,16,31558,13,1277,,,,
204.79.197.239,0,105,43882,0,0,58,33002,47,10880,,,,
95.101.142.225,0,50,9107,0,0,28,4260,22,4847,,,,
72.25.64.8,0,68,64569,0,0,33,31244,35,33325,,,,
255.255.255.255,0,3,1046,0,0,0,0,3,1046,,,,
23.60.21.15,0,20,3177,0,0,8,2051,12,1126,,,,
93.184.221.240,0,12,1819,0,0,5,861,7,958,,,,
34.117.121.53,0,69,19912,0,0,37,16487,32,3425,,,,
52.85.49.34,0,77,20239,0,0,39,15339,38,4900,,,,
51.124.78.146,0,66,317721,0,0,39,314630,27,3091,,,,
54.214.185.83,0,19,8432,0,0,9,5922,10,2510,,,,
34.120.158.37,0,657,2135460,0,0,414,2099044,243,36416,,,,
34.98.75.36,0,41,9096,0,0,21,6618,20,2478,,,,
216.58.210.174,0,2303,1353263,0,0,1429,936910,874,416353,,,,
216.58.209.163,0,627,914646,0,0,391,856210,236,58436,,,,
216.58.210.129,0,2185,7868658,0,0,1150,7780399,1035,88259,,,,
216.58.211.237,0,286,78208,0,0,151,39790,135,38418,,,,
216.58.211.238,0,461,160070,0,0,254,110981,207,49089,,,,
20.189.173.1,0,27,8571,0,0,13,5691,14,2880,,,,
18.192.231.252,0,41,7806,0,0,20,5927,21,1879,,,,
216.58.209.202,0,97,24919,0,0,48,16172,49,8747,,,,
216.58.209.197,0,3363,4597925,0,0,2277,4187402,1086,410523,,,,
216.58.211.228,0,98,52269,0,0,53,43203,45,9066,,,,
216.58.210.161,0,376,1216378,0,0,256,1201676,120,14702,,,,
216.58.211.225,0,290,224248,0,0,150,203520,140,20728,,,,
216.58.210.170,0,150,47282,0,0,77,35583,73,11699,,,,
54.77.70.157,0,35,8450,0,0,17,5798,18,2652,,,,
91.195.247.8,0,45,8413,0,0,23,5642,22,2771,,,,
104.18.14.101,0,39,3698,0,0,18,2094,21,1604,,,,
91.195.247.11,0,629,1317554,0,0,439,1286532,190,31022,,,,
104.76.24.246,0,71,130641,0,0,45,127833,26,2808,,,,
91.195.246.80,0,48,9171,0,0,25,5781,23,3390,,,,
130.233.231.219,0,21,9505,0,0,11,8397,10,1108,,,,
18.165.122.26,0,54,19977,0,0,25,16897,29,3080,,,,
34.160.90.233,0,149,37717,0,0,78,29190,71,8527,,,,
34.160.178.214,0,48,17929,0,0,26,13394,22,4535,,,,
18.165.140.127,0,737,1119105,0,0,443,1086352,294,32753,,,,
104.18.32.90,0,114,53208,0,0,52,46243,62,6965,,,,
18.165.140.68,0,268,484414,0,0,133,468406,135,16008,,,,
2.21.240.165,0,168,211080,0,0,95,203286,73,7794,,,,
23.61.233.27,0,177,39330,0,0,98,27712,79,11618,,,,
2.22.31.104,0,237,146788,0,0,113,79344,124,67444,,,,
20.190.177.83,0,23,30236,0,0,9,21935,14,8301,,,,
52.98.149.162,0,25,9313,0,0,12,6773,13,2540,,,,
52.168.117.168,0,29,10478,0,0,12,7461,17,3017,,,,
20.105.95.163,0,17,11049,0,0,7,8400,10,2649,,,,
204.79.197.254,0,30,10374,0,0,17,8429,13,1945,,,,
216.58.210.142,0,144,54810,0,0,73,45080,71,9730,,,,
108.177.14.188,0,31,9943,0,0,17,8411,14,1532,,,,
216.58.211.229,0,84,98066,0,0,47,91646,37,6420,,,,
64.233.165.101,0,43,14774,0,0,21,11355,22,3419,,,,
108.156.22.66,0,178,157393,0,0,106,144993,72,12400,,,,
108.156.22.13,0,29,16150,0,0,15,14241,14,1909,,,,
108.156.22.39,0,39,48697,0,0,21,45961,18,2736,,,,
185.199.111.153,0,67,67313,0,0,39,63782,28,3531,,,,
5.75.231.96,0,110,27914,0,0,49,19337,61,8577,,,,
172.67.191.28,0,205,528477,0,0,165,524510,40,3967,,,,
151.101.245.91,0,91,279413,0,0,64,276203,27,3210,,,,
216.58.209.195,0,320,276689,0,0,200,240204,120,36485,,,,
213.230.210.231,0,47,110237,0,0,28,107929,19,2308,,,,
34.160.122.198,0,49,92346,0,0,25,89193,24,3153,,,,
108.156.22.29,0,27,13270,0,0,14,11370,13,1900,,,,
151.101.245.229,0,44,46155,0,0,25,43351,19,2804,,,,
172.66.47.32,0,139,373947,0,0,101,370040,38,3907,,,,
54.246.51.107,0,39,10272,0,0,20,7250,19,3022,,,,
35.185.44.232,0,34,29167,0,0,17,27118,17,2049,,,,
34.104.35.123,0,2238,8518776,0,0,1204,8430144,1034,88632,,,,
138.201.94.34,0,51,10280,0,0,25,7001,26,3279,,,,
216.58.210.133,0,221,101823,0,0,119,59120,102,42703,,,,
34.120.214.181,0,49,41951,0,0,38,38283,11,3668,,,,
34.196.123.226,0,40,12089,0,0,20,8655,20,3434,,,,
159.69.190.238,0,110,25080,0,0,51,14078,59,11002,,,,
52.58.254.253,0,41,7805,0,0,20,5926,21,1879,,,,
152.199.20.80,0,48,14129,0,0,23,11596,25,2533,,,,
2.18.74.119,0,46,13320,0,0,23,2166,23,11154,,,,
52.142.223.178,0,39,18303,0,0,19,7344,20,10959,,,,
140.82.121.6,0,23,6670,0,0,10,5449,13,1221,,,,
185.136.68.145,0,68,21040,0,0,40,13563,28,7477,,,,
13.107.5.88,0,18,7413,0,0,10,5739,8,1674,,,,
152.199.20.202,0,20,6780,0,0,9,5293,11,1487,,,,
20.190.181.3,0,24,23252,0,0,11,16984,13,6268,,,,
52.85.49.50,0,21,8935,0,0,11,7112,10,1823,,,,
62.183.170.16,0,23,8314,0,0,12,6248,11,2066,,,,
54.246.205.176,0,37,12042,0,0,20,8613,17,3429,,,,
